Hash-Attack Results:
BIT SIZE[1]    TEST[0]:  Pre-Image Completed after	1       iterations and collisions completed after	1       iterations
BIT SIZE[1]    TEST[1]:  Pre-Image Completed after	1       iterations and collisions completed after	1       iterations
BIT SIZE[1]    TEST[2]:  Pre-Image Completed after	1       iterations and collisions completed after	1       iterations
BIT SIZE[1]    TEST[3]:  Pre-Image Completed after	1       iterations and collisions completed after	1       iterations
BIT SIZE[1]    TEST[4]:  Pre-Image Completed after	1       iterations and collisions completed after	1       iterations
BIT SIZE[1]    TEST[5]:  Pre-Image Completed after	1       iterations and collisions completed after	1       iterations
BIT SIZE[1]    TEST[6]:  Pre-Image Completed after	1       iterations and collisions completed after	1       iterations
BIT SIZE[1]    TEST[7]:  Pre-Image Completed after	1       iterations and collisions completed after	1       iterations
BIT SIZE[1]    TEST[8]:  Pre-Image Completed after	1       iterations and collisions completed after	1       iterations
BIT SIZE[1]    TEST[9]:  Pre-Image Completed after	1       iterations and collisions completed after	1       iterations
BIT SIZE[1]    TEST[10]: Pre-Image Completed after	1       iterations and collisions completed after	1       iterations
BIT SIZE[1]    TEST[11]: Pre-Image Completed after	1       iterations and collisions completed after	1       iterations
BIT SIZE[1]    TEST[12]: Pre-Image Completed after	1       iterations and collisions completed after	1       iterations
BIT SIZE[1]    TEST[13]: Pre-Image Completed after	1       iterations and collisions completed after	1       iterations
BIT SIZE[1]    TEST[14]: Pre-Image Completed after	1       iterations and collisions completed after	1       iterations
BIT SIZE[1]    TEST[15]: Pre-Image Completed after	1       iterations and collisions completed after	1       iterations
BIT SIZE[1]    TEST[16]: Pre-Image Completed after	1       iterations and collisions completed after	1       iterations
BIT SIZE[1]    TEST[17]: Pre-Image Completed after	1       iterations and collisions completed after	1       iterations
BIT SIZE[1]    TEST[18]: Pre-Image Completed after	1       iterations and collisions completed after	1       iterations
BIT SIZE[1]    TEST[19]: Pre-Image Completed after	1       iterations and collisions completed after	1       iterations
BIT SIZE[1]    TEST[20]: Pre-Image Completed after	1       iterations and collisions completed after	1       iterations
BIT SIZE[1]    TEST[21]: Pre-Image Completed after	1       iterations and collisions completed after	1       iterations
BIT SIZE[1]    TEST[22]: Pre-Image Completed after	1       iterations and collisions completed after	1       iterations
BIT SIZE[1]    TEST[23]: Pre-Image Completed after	1       iterations and collisions completed after	1       iterations
BIT SIZE[1]    TEST[24]: Pre-Image Completed after	1       iterations and collisions completed after	1       iterations
BIT SIZE[1]    TEST[25]: Pre-Image Completed after	1       iterations and collisions completed after	1       iterations
BIT SIZE[1]    TEST[26]: Pre-Image Completed after	1       iterations and collisions completed after	1       iterations
BIT SIZE[1]    TEST[27]: Pre-Image Completed after	1       iterations and collisions completed after	1       iterations
BIT SIZE[1]    TEST[28]: Pre-Image Completed after	1       iterations and collisions completed after	1       iterations
BIT SIZE[1]    TEST[29]: Pre-Image Completed after	1       iterations and collisions completed after	1       iterations
BIT SIZE[1]    TEST[30]: Pre-Image Completed after	128     iterations and collisions completed after	2       iterations
BIT SIZE[1]    TEST[31]: Pre-Image Completed after	1       iterations and collisions completed after	1       iterations
BIT SIZE[1]    TEST[32]: Pre-Image Completed after	1       iterations and collisions completed after	1       iterations
BIT SIZE[1]    TEST[33]: Pre-Image Completed after	1       iterations and collisions completed after	1       iterations
BIT SIZE[1]    TEST[34]: Pre-Image Completed after	1       iterations and collisions completed after	1       iterations
BIT SIZE[1]    TEST[35]: Pre-Image Completed after	1       iterations and collisions completed after	1       iterations
BIT SIZE[1]    TEST[36]: Pre-Image Completed after	1       iterations and collisions completed after	1       iterations
BIT SIZE[1]    TEST[37]: Pre-Image Completed after	1       iterations and collisions completed after	1       iterations
BIT SIZE[1]    TEST[38]: Pre-Image Completed after	1       iterations and collisions completed after	1       iterations
BIT SIZE[1]    TEST[39]: Pre-Image Completed after	1       iterations and collisions completed after	1       iterations
BIT SIZE[1]    TEST[40]: Pre-Image Completed after	1       iterations and collisions completed after	1       iterations
BIT SIZE[1]    TEST[41]: Pre-Image Completed after	1       iterations and collisions completed after	1       iterations
BIT SIZE[1]    TEST[42]: Pre-Image Completed after	1       iterations and collisions completed after	1       iterations
BIT SIZE[1]    TEST[43]: Pre-Image Completed after	1       iterations and collisions completed after	1       iterations
BIT SIZE[1]    TEST[44]: Pre-Image Completed after	1       iterations and collisions completed after	1       iterations
BIT SIZE[1]    TEST[45]: Pre-Image Completed after	1       iterations and collisions completed after	1       iterations
BIT SIZE[1]    TEST[46]: Pre-Image Completed after	1       iterations and collisions completed after	1       iterations
BIT SIZE[1]    TEST[47]: Pre-Image Completed after	1       iterations and collisions completed after	1       iterations
BIT SIZE[1]    TEST[48]: Pre-Image Completed after	1       iterations and collisions completed after	1       iterations
BIT SIZE[1]    TEST[49]: Pre-Image Completed after	1       iterations and collisions completed after	1       iterations
BIT SIZE[2]    TEST[0]:  Pre-Image Completed after	2       iterations and collisions completed after	2       iterations
BIT SIZE[2]    TEST[1]:  Pre-Image Completed after	2       iterations and collisions completed after	2       iterations
BIT SIZE[2]    TEST[2]:  Pre-Image Completed after	1       iterations and collisions completed after	1       iterations
BIT SIZE[2]    TEST[3]:  Pre-Image Completed after	140     iterations and collisions completed after	2       iterations
BIT SIZE[2]    TEST[4]:  Pre-Image Completed after	1       iterations and collisions completed after	1       iterations
BIT SIZE[2]    TEST[5]:  Pre-Image Completed after	1       iterations and collisions completed after	1       iterations
BIT SIZE[2]    TEST[6]:  Pre-Image Completed after	2       iterations and collisions completed after	2       iterations
BIT SIZE[2]    TEST[7]:  Pre-Image Completed after	3       iterations and collisions completed after	2       iterations
BIT SIZE[2]    TEST[8]:  Pre-Image Completed after	2       iterations and collisions completed after	2       iterations
BIT SIZE[2]    TEST[9]:  Pre-Image Completed after	4       iterations and collisions completed after	2       iterations
BIT SIZE[2]    TEST[10]: Pre-Image Completed after	1       iterations and collisions completed after	1       iterations
BIT SIZE[2]    TEST[11]: Pre-Image Completed after	2       iterations and collisions completed after	2       iterations
BIT SIZE[2]    TEST[12]: Pre-Image Completed after	1       iterations and collisions completed after	1       iterations
BIT SIZE[2]    TEST[13]: Pre-Image Completed after	3       iterations and collisions completed after	2       iterations
BIT SIZE[2]    TEST[14]: Pre-Image Completed after	2       iterations and collisions completed after	2       iterations
BIT SIZE[2]    TEST[15]: Pre-Image Completed after	1       iterations and collisions completed after	1       iterations
BIT SIZE[2]    TEST[16]: Pre-Image Completed after	2       iterations and collisions completed after	2       iterations
BIT SIZE[2]    TEST[17]: Pre-Image Completed after	1       iterations and collisions completed after	1       iterations
BIT SIZE[2]    TEST[18]: Pre-Image Completed after	2       iterations and collisions completed after	2       iterations
BIT SIZE[2]    TEST[19]: Pre-Image Completed after	1       iterations and collisions completed after	1       iterations
BIT SIZE[2]    TEST[20]: Pre-Image Completed after	7       iterations and collisions completed after	2       iterations
BIT SIZE[2]    TEST[21]: Pre-Image Completed after	3       iterations and collisions completed after	2       iterations
BIT SIZE[2]    TEST[22]: Pre-Image Completed after	1       iterations and collisions completed after	1       iterations
BIT SIZE[2]    TEST[23]: Pre-Image Completed after	1       iterations and collisions completed after	1       iterations
BIT SIZE[2]    TEST[24]: Pre-Image Completed after	1       iterations and collisions completed after	1       iterations
BIT SIZE[2]    TEST[25]: Pre-Image Completed after	1       iterations and collisions completed after	1       iterations
BIT SIZE[2]    TEST[26]: Pre-Image Completed after	1       iterations and collisions completed after	1       iterations
BIT SIZE[2]    TEST[27]: Pre-Image Completed after	1       iterations and collisions completed after	1       iterations
BIT SIZE[2]    TEST[28]: Pre-Image Completed after	3       iterations and collisions completed after	2       iterations
BIT SIZE[2]    TEST[29]: Pre-Image Completed after	1       iterations and collisions completed after	1       iterations
BIT SIZE[2]    TEST[30]: Pre-Image Completed after	1       iterations and collisions completed after	1       iterations
BIT SIZE[2]    TEST[31]: Pre-Image Completed after	1       iterations and collisions completed after	1       iterations
BIT SIZE[2]    TEST[32]: Pre-Image Completed after	1       iterations and collisions completed after	1       iterations
BIT SIZE[2]    TEST[33]: Pre-Image Completed after	1       iterations and collisions completed after	1       iterations
BIT SIZE[2]    TEST[34]: Pre-Image Completed after	2       iterations and collisions completed after	2       iterations
BIT SIZE[2]    TEST[35]: Pre-Image Completed after	1       iterations and collisions completed after	1       iterations
BIT SIZE[2]    TEST[36]: Pre-Image Completed after	2       iterations and collisions completed after	2       iterations
BIT SIZE[2]    TEST[37]: Pre-Image Completed after	1       iterations and collisions completed after	1       iterations
BIT SIZE[2]    TEST[38]: Pre-Image Completed after	3       iterations and collisions completed after	2       iterations
BIT SIZE[2]    TEST[39]: Pre-Image Completed after	2       iterations and collisions completed after	2       iterations
BIT SIZE[2]    TEST[40]: Pre-Image Completed after	1       iterations and collisions completed after	1       iterations
BIT SIZE[2]    TEST[41]: Pre-Image Completed after	5       iterations and collisions completed after	2       iterations
BIT SIZE[2]    TEST[42]: Pre-Image Completed after	1       iterations and collisions completed after	1       iterations
BIT SIZE[2]    TEST[43]: Pre-Image Completed after	1       iterations and collisions completed after	1       iterations
BIT SIZE[2]    TEST[44]: Pre-Image Completed after	6       iterations and collisions completed after	2       iterations
BIT SIZE[2]    TEST[45]: Pre-Image Completed after	1       iterations and collisions completed after	1       iterations
BIT SIZE[2]    TEST[46]: Pre-Image Completed after	1       iterations and collisions completed after	1       iterations
BIT SIZE[2]    TEST[47]: Pre-Image Completed after	5       iterations and collisions completed after	2       iterations
BIT SIZE[2]    TEST[48]: Pre-Image Completed after	1       iterations and collisions completed after	1       iterations
BIT SIZE[2]    TEST[49]: Pre-Image Completed after	2       iterations and collisions completed after	2       iterations
BIT SIZE[3]    TEST[0]:  Pre-Image Completed after	2       iterations and collisions completed after	2       iterations
BIT SIZE[3]    TEST[1]:  Pre-Image Completed after	7       iterations and collisions completed after	2       iterations
BIT SIZE[3]    TEST[2]:  Pre-Image Completed after	6       iterations and collisions completed after	3       iterations
BIT SIZE[3]    TEST[3]:  Pre-Image Completed after	2       iterations and collisions completed after	2       iterations
BIT SIZE[3]    TEST[4]:  Pre-Image Completed after	1       iterations and collisions completed after	1       iterations
BIT SIZE[3]    TEST[5]:  Pre-Image Completed after	1       iterations and collisions completed after	1       iterations
BIT SIZE[3]    TEST[6]:  Pre-Image Completed after	1       iterations and collisions completed after	1       iterations
BIT SIZE[3]    TEST[7]:  Pre-Image Completed after	1       iterations and collisions completed after	1       iterations
BIT SIZE[3]    TEST[8]:  Pre-Image Completed after	1       iterations and collisions completed after	1       iterations
BIT SIZE[3]    TEST[9]:  Pre-Image Completed after	5       iterations and collisions completed after	3       iterations
BIT SIZE[3]    TEST[10]: Pre-Image Completed after	5       iterations and collisions completed after	3       iterations
BIT SIZE[3]    TEST[11]: Pre-Image Completed after	5       iterations and collisions completed after	3       iterations
BIT SIZE[3]    TEST[12]: Pre-Image Completed after	7       iterations and collisions completed after	3       iterations
BIT SIZE[3]    TEST[13]: Pre-Image Completed after	7       iterations and collisions completed after	2       iterations
BIT SIZE[3]    TEST[14]: Pre-Image Completed after	2       iterations and collisions completed after	2       iterations
BIT SIZE[3]    TEST[15]: Pre-Image Completed after	1       iterations and collisions completed after	1       iterations
BIT SIZE[3]    TEST[16]: Pre-Image Completed after	1       iterations and collisions completed after	1       iterations
BIT SIZE[3]    TEST[17]: Pre-Image Completed after	12      iterations and collisions completed after	2       iterations
BIT SIZE[3]    TEST[18]: Pre-Image Completed after	1       iterations and collisions completed after	1       iterations
BIT SIZE[3]    TEST[19]: Pre-Image Completed after	1       iterations and collisions completed after	1       iterations
BIT SIZE[3]    TEST[20]: Pre-Image Completed after	5       iterations and collisions completed after	3       iterations
BIT SIZE[3]    TEST[21]: Pre-Image Completed after	7       iterations and collisions completed after	3       iterations
BIT SIZE[3]    TEST[22]: Pre-Image Completed after	1       iterations and collisions completed after	1       iterations
BIT SIZE[3]    TEST[23]: Pre-Image Completed after	7       iterations and collisions completed after	2       iterations
BIT SIZE[3]    TEST[24]: Pre-Image Completed after	1       iterations and collisions completed after	1       iterations
BIT SIZE[3]    TEST[25]: Pre-Image Completed after	1       iterations and collisions completed after	1       iterations
BIT SIZE[3]    TEST[26]: Pre-Image Completed after	9       iterations and collisions completed after	4       iterations
BIT SIZE[3]    TEST[27]: Pre-Image Completed after	7       iterations and collisions completed after	4       iterations
BIT SIZE[3]    TEST[28]: Pre-Image Completed after	1       iterations and collisions completed after	1       iterations
BIT SIZE[3]    TEST[29]: Pre-Image Completed after	1       iterations and collisions completed after	1       iterations
BIT SIZE[3]    TEST[30]: Pre-Image Completed after	7       iterations and collisions completed after	4       iterations
BIT SIZE[3]    TEST[31]: Pre-Image Completed after	6       iterations and collisions completed after	4       iterations
BIT SIZE[3]    TEST[32]: Pre-Image Completed after	3       iterations and collisions completed after	2       iterations
BIT SIZE[3]    TEST[33]: Pre-Image Completed after	4       iterations and collisions completed after	3       iterations
BIT SIZE[3]    TEST[34]: Pre-Image Completed after	1       iterations and collisions completed after	1       iterations
BIT SIZE[3]    TEST[35]: Pre-Image Completed after	6       iterations and collisions completed after	3       iterations
BIT SIZE[3]    TEST[36]: Pre-Image Completed after	6       iterations and collisions completed after	2       iterations
BIT SIZE[3]    TEST[37]: Pre-Image Completed after	8       iterations and collisions completed after	2       iterations
BIT SIZE[3]    TEST[38]: Pre-Image Completed after	5       iterations and collisions completed after	2       iterations
BIT SIZE[3]    TEST[39]: Pre-Image Completed after	6       iterations and collisions completed after	3       iterations
BIT SIZE[3]    TEST[40]: Pre-Image Completed after	6       iterations and collisions completed after	2       iterations
BIT SIZE[3]    TEST[41]: Pre-Image Completed after	9       iterations and collisions completed after	4       iterations
BIT SIZE[3]    TEST[42]: Pre-Image Completed after	9       iterations and collisions completed after	4       iterations
BIT SIZE[3]    TEST[43]: Pre-Image Completed after	4       iterations and collisions completed after	3       iterations
BIT SIZE[3]    TEST[44]: Pre-Image Completed after	2       iterations and collisions completed after	2       iterations
BIT SIZE[3]    TEST[45]: Pre-Image Completed after	1       iterations and collisions completed after	1       iterations
BIT SIZE[3]    TEST[46]: Pre-Image Completed after	4       iterations and collisions completed after	2       iterations
BIT SIZE[3]    TEST[47]: Pre-Image Completed after	1       iterations and collisions completed after	1       iterations
BIT SIZE[3]    TEST[48]: Pre-Image Completed after	3       iterations and collisions completed after	3       iterations
BIT SIZE[3]    TEST[49]: Pre-Image Completed after	1       iterations and collisions completed after	1       iterations
BIT SIZE[4]    TEST[0]:  Pre-Image Completed after	2       iterations and collisions completed after	2       iterations
BIT SIZE[4]    TEST[1]:  Pre-Image Completed after	40      iterations and collisions completed after	3       iterations
BIT SIZE[4]    TEST[2]:  Pre-Image Completed after	1       iterations and collisions completed after	1       iterations
BIT SIZE[4]    TEST[3]:  Pre-Image Completed after	2       iterations and collisions completed after	2       iterations
BIT SIZE[4]    TEST[4]:  Pre-Image Completed after	2       iterations and collisions completed after	2       iterations
BIT SIZE[4]    TEST[5]:  Pre-Image Completed after	14      iterations and collisions completed after	5       iterations
BIT SIZE[4]    TEST[6]:  Pre-Image Completed after	4       iterations and collisions completed after	3       iterations
BIT SIZE[4]    TEST[7]:  Pre-Image Completed after	6       iterations and collisions completed after	6       iterations
BIT SIZE[4]    TEST[8]:  Pre-Image Completed after	18      iterations and collisions completed after	5       iterations
BIT SIZE[4]    TEST[9]:  Pre-Image Completed after	8       iterations and collisions completed after	6       iterations
BIT SIZE[4]    TEST[10]: Pre-Image Completed after	10      iterations and collisions completed after	6       iterations
BIT SIZE[4]    TEST[11]: Pre-Image Completed after	17      iterations and collisions completed after	4       iterations
BIT SIZE[4]    TEST[12]: Pre-Image Completed after	2       iterations and collisions completed after	2       iterations
BIT SIZE[4]    TEST[13]: Pre-Image Completed after	8       iterations and collisions completed after	7       iterations
BIT SIZE[4]    TEST[14]: Pre-Image Completed after	2       iterations and collisions completed after	2       iterations
BIT SIZE[4]    TEST[15]: Pre-Image Completed after	6       iterations and collisions completed after	6       iterations
BIT SIZE[4]    TEST[16]: Pre-Image Completed after	14      iterations and collisions completed after	4       iterations
BIT SIZE[4]    TEST[17]: Pre-Image Completed after	20      iterations and collisions completed after	5       iterations
BIT SIZE[4]    TEST[18]: Pre-Image Completed after	10      iterations and collisions completed after	5       iterations
BIT SIZE[4]    TEST[19]: Pre-Image Completed after	14      iterations and collisions completed after	4       iterations
BIT SIZE[4]    TEST[20]: Pre-Image Completed after	36      iterations and collisions completed after	7       iterations
BIT SIZE[4]    TEST[21]: Pre-Image Completed after	5       iterations and collisions completed after	2       iterations
BIT SIZE[4]    TEST[22]: Pre-Image Completed after	5       iterations and collisions completed after	4       iterations
BIT SIZE[4]    TEST[23]: Pre-Image Completed after	1       iterations and collisions completed after	1       iterations
BIT SIZE[4]    TEST[24]: Pre-Image Completed after	5       iterations and collisions completed after	4       iterations
BIT SIZE[4]    TEST[25]: Pre-Image Completed after	21      iterations and collisions completed after	7       iterations
BIT SIZE[4]    TEST[26]: Pre-Image Completed after	1       iterations and collisions completed after	1       iterations
BIT SIZE[4]    TEST[27]: Pre-Image Completed after	8       iterations and collisions completed after	7       iterations
BIT SIZE[4]    TEST[28]: Pre-Image Completed after	9       iterations and collisions completed after	4       iterations
BIT SIZE[4]    TEST[29]: Pre-Image Completed after	4       iterations and collisions completed after	4       iterations
BIT SIZE[4]    TEST[30]: Pre-Image Completed after	29      iterations and collisions completed after	3       iterations
BIT SIZE[4]    TEST[31]: Pre-Image Completed after	15      iterations and collisions completed after	5       iterations
BIT SIZE[4]    TEST[32]: Pre-Image Completed after	3       iterations and collisions completed after	3       iterations
BIT SIZE[4]    TEST[33]: Pre-Image Completed after	2       iterations and collisions completed after	2       iterations
BIT SIZE[4]    TEST[34]: Pre-Image Completed after	3       iterations and collisions completed after	3       iterations
BIT SIZE[4]    TEST[35]: Pre-Image Completed after	32      iterations and collisions completed after	4       iterations
BIT SIZE[4]    TEST[36]: Pre-Image Completed after	1       iterations and collisions completed after	1       iterations
BIT SIZE[4]    TEST[37]: Pre-Image Completed after	3       iterations and collisions completed after	3       iterations
BIT SIZE[4]    TEST[38]: Pre-Image Completed after	4       iterations and collisions completed after	2       iterations
BIT SIZE[4]    TEST[39]: Pre-Image Completed after	8       iterations and collisions completed after	5       iterations
BIT SIZE[4]    TEST[40]: Pre-Image Completed after	6       iterations and collisions completed after	4       iterations
BIT SIZE[4]    TEST[41]: Pre-Image Completed after	11      iterations and collisions completed after	4       iterations
BIT SIZE[4]    TEST[42]: Pre-Image Completed after	5       iterations and collisions completed after	4       iterations
BIT SIZE[4]    TEST[43]: Pre-Image Completed after	7       iterations and collisions completed after	5       iterations
BIT SIZE[4]    TEST[44]: Pre-Image Completed after	11      iterations and collisions completed after	3       iterations
BIT SIZE[4]    TEST[45]: Pre-Image Completed after	3       iterations and collisions completed after	3       iterations
BIT SIZE[4]    TEST[46]: Pre-Image Completed after	11      iterations and collisions completed after	2       iterations
BIT SIZE[4]    TEST[47]: Pre-Image Completed after	3       iterations and collisions completed after	3       iterations
BIT SIZE[4]    TEST[48]: Pre-Image Completed after	4       iterations and collisions completed after	4       iterations
BIT SIZE[4]    TEST[49]: Pre-Image Completed after	8       iterations and collisions completed after	2       iterations
BIT SIZE[5]    TEST[0]:  Pre-Image Completed after	55      iterations and collisions completed after	3       iterations
BIT SIZE[5]    TEST[1]:  Pre-Image Completed after	71      iterations and collisions completed after	7       iterations
BIT SIZE[5]    TEST[2]:  Pre-Image Completed after	2       iterations and collisions completed after	2       iterations
BIT SIZE[5]    TEST[3]:  Pre-Image Completed after	40      iterations and collisions completed after	4       iterations
BIT SIZE[5]    TEST[4]:  Pre-Image Completed after	34      iterations and collisions completed after	5       iterations
BIT SIZE[5]    TEST[5]:  Pre-Image Completed after	27      iterations and collisions completed after	8       iterations
BIT SIZE[5]    TEST[6]:  Pre-Image Completed after	9       iterations and collisions completed after	3       iterations
BIT SIZE[5]    TEST[7]:  Pre-Image Completed after	1       iterations and collisions completed after	1       iterations
BIT SIZE[5]    TEST[8]:  Pre-Image Completed after	2       iterations and collisions completed after	2       iterations
BIT SIZE[5]    TEST[9]:  Pre-Image Completed after	5       iterations and collisions completed after	5       iterations
BIT SIZE[5]    TEST[10]: Pre-Image Completed after	18      iterations and collisions completed after	4       iterations
BIT SIZE[5]    TEST[11]: Pre-Image Completed after	37      iterations and collisions completed after	5       iterations
BIT SIZE[5]    TEST[12]: Pre-Image Completed after	9       iterations and collisions completed after	8       iterations
BIT SIZE[5]    TEST[13]: Pre-Image Completed after	8       iterations and collisions completed after	5       iterations
BIT SIZE[5]    TEST[14]: Pre-Image Completed after	9       iterations and collisions completed after	7       iterations
BIT SIZE[5]    TEST[15]: Pre-Image Completed after	5       iterations and collisions completed after	4       iterations
BIT SIZE[5]    TEST[16]: Pre-Image Completed after	10      iterations and collisions completed after	9       iterations
BIT SIZE[5]    TEST[17]: Pre-Image Completed after	42      iterations and collisions completed after	4       iterations
BIT SIZE[5]    TEST[18]: Pre-Image Completed after	1       iterations and collisions completed after	1       iterations
BIT SIZE[5]    TEST[19]: Pre-Image Completed after	1       iterations and collisions completed after	1       iterations
BIT SIZE[5]    TEST[20]: Pre-Image Completed after	16      iterations and collisions completed after	3       iterations
BIT SIZE[5]    TEST[21]: Pre-Image Completed after	22      iterations and collisions completed after	4       iterations
BIT SIZE[5]    TEST[22]: Pre-Image Completed after	9       iterations and collisions completed after	4       iterations
BIT SIZE[5]    TEST[23]: Pre-Image Completed after	26      iterations and collisions completed after	6       iterations
BIT SIZE[5]    TEST[24]: Pre-Image Completed after	33      iterations and collisions completed after	5       iterations
BIT SIZE[5]    TEST[25]: Pre-Image Completed after	2       iterations and collisions completed after	2       iterations
BIT SIZE[5]    TEST[26]: Pre-Image Completed after	27      iterations and collisions completed after	3       iterations
BIT SIZE[5]    TEST[27]: Pre-Image Completed after	1       iterations and collisions completed after	1       iterations
BIT SIZE[5]    TEST[28]: Pre-Image Completed after	18      iterations and collisions completed after	3       iterations
BIT SIZE[5]    TEST[29]: Pre-Image Completed after	21      iterations and collisions completed after	8       iterations
BIT SIZE[5]    TEST[30]: Pre-Image Completed after	12      iterations and collisions completed after	6       iterations
BIT SIZE[5]    TEST[31]: Pre-Image Completed after	14      iterations and collisions completed after	3       iterations
BIT SIZE[5]    TEST[32]: Pre-Image Completed after	53      iterations and collisions completed after	10      iterations
BIT SIZE[5]    TEST[33]: Pre-Image Completed after	10      iterations and collisions completed after	5       iterations
BIT SIZE[5]    TEST[34]: Pre-Image Completed after	3       iterations and collisions completed after	3       iterations
BIT SIZE[5]    TEST[35]: Pre-Image Completed after	7       iterations and collisions completed after	7       iterations
BIT SIZE[5]    TEST[36]: Pre-Image Completed after	19      iterations and collisions completed after	9       iterations
BIT SIZE[5]    TEST[37]: Pre-Image Completed after	7       iterations and collisions completed after	6       iterations
BIT SIZE[5]    TEST[38]: Pre-Image Completed after	18      iterations and collisions completed after	4       iterations
BIT SIZE[5]    TEST[39]: Pre-Image Completed after	26      iterations and collisions completed after	6       iterations
BIT SIZE[5]    TEST[40]: Pre-Image Completed after	8       iterations and collisions completed after	4       iterations
BIT SIZE[5]    TEST[41]: Pre-Image Completed after	8       iterations and collisions completed after	3       iterations
BIT SIZE[5]    TEST[42]: Pre-Image Completed after	20      iterations and collisions completed after	4       iterations
BIT SIZE[5]    TEST[43]: Pre-Image Completed after	6       iterations and collisions completed after	3       iterations
BIT SIZE[5]    TEST[44]: Pre-Image Completed after	1       iterations and collisions completed after	1       iterations
BIT SIZE[5]    TEST[45]: Pre-Image Completed after	28      iterations and collisions completed after	6       iterations
BIT SIZE[5]    TEST[46]: Pre-Image Completed after	46      iterations and collisions completed after	9       iterations
BIT SIZE[5]    TEST[47]: Pre-Image Completed after	13      iterations and collisions completed after	3       iterations
BIT SIZE[5]    TEST[48]: Pre-Image Completed after	15      iterations and collisions completed after	5       iterations
BIT SIZE[5]    TEST[49]: Pre-Image Completed after	19      iterations and collisions completed after	4       iterations
BIT SIZE[6]    TEST[0]:  Pre-Image Completed after	6       iterations and collisions completed after	4       iterations
BIT SIZE[6]    TEST[1]:  Pre-Image Completed after	8       iterations and collisions completed after	8       iterations
BIT SIZE[6]    TEST[2]:  Pre-Image Completed after	52      iterations and collisions completed after	10      iterations
BIT SIZE[6]    TEST[3]:  Pre-Image Completed after	119     iterations and collisions completed after	8       iterations
BIT SIZE[6]    TEST[4]:  Pre-Image Completed after	29      iterations and collisions completed after	11      iterations
BIT SIZE[6]    TEST[5]:  Pre-Image Completed after	100     iterations and collisions completed after	4       iterations
BIT SIZE[6]    TEST[6]:  Pre-Image Completed after	30      iterations and collisions completed after	4       iterations
BIT SIZE[6]    TEST[7]:  Pre-Image Completed after	65      iterations and collisions completed after	3       iterations
BIT SIZE[6]    TEST[8]:  Pre-Image Completed after	10      iterations and collisions completed after	10      iterations
BIT SIZE[6]    TEST[9]:  Pre-Image Completed after	8       iterations and collisions completed after	8       iterations
BIT SIZE[6]    TEST[10]: Pre-Image Completed after	39      iterations and collisions completed after	16      iterations
BIT SIZE[6]    TEST[11]: Pre-Image Completed after	76      iterations and collisions completed after	9       iterations
BIT SIZE[6]    TEST[12]: Pre-Image Completed after	10      iterations and collisions completed after	9       iterations
BIT SIZE[6]    TEST[13]: Pre-Image Completed after	5       iterations and collisions completed after	5       iterations
BIT SIZE[6]    TEST[14]: Pre-Image Completed after	4       iterations and collisions completed after	4       iterations
BIT SIZE[6]    TEST[15]: Pre-Image Completed after	6       iterations and collisions completed after	6       iterations
BIT SIZE[6]    TEST[16]: Pre-Image Completed after	31      iterations and collisions completed after	5       iterations
BIT SIZE[6]    TEST[17]: Pre-Image Completed after	10      iterations and collisions completed after	9       iterations
BIT SIZE[6]    TEST[18]: Pre-Image Completed after	25      iterations and collisions completed after	7       iterations
BIT SIZE[6]    TEST[19]: Pre-Image Completed after	55      iterations and collisions completed after	6       iterations
BIT SIZE[6]    TEST[20]: Pre-Image Completed after	15      iterations and collisions completed after	10      iterations
BIT SIZE[6]    TEST[21]: Pre-Image Completed after	52      iterations and collisions completed after	4       iterations
BIT SIZE[6]    TEST[22]: Pre-Image Completed after	24      iterations and collisions completed after	3       iterations
BIT SIZE[6]    TEST[23]: Pre-Image Completed after	13      iterations and collisions completed after	10      iterations
BIT SIZE[6]    TEST[24]: Pre-Image Completed after	9       iterations and collisions completed after	9       iterations
BIT SIZE[6]    TEST[25]: Pre-Image Completed after	40      iterations and collisions completed after	13      iterations
BIT SIZE[6]    TEST[26]: Pre-Image Completed after	6       iterations and collisions completed after	6       iterations
BIT SIZE[6]    TEST[27]: Pre-Image Completed after	4       iterations and collisions completed after	4       iterations
BIT SIZE[6]    TEST[28]: Pre-Image Completed after	45      iterations and collisions completed after	7       iterations
BIT SIZE[6]    TEST[29]: Pre-Image Completed after	7       iterations and collisions completed after	7       iterations
BIT SIZE[6]    TEST[30]: Pre-Image Completed after	21      iterations and collisions completed after	10      iterations
BIT SIZE[6]    TEST[31]: Pre-Image Completed after	32      iterations and collisions completed after	7       iterations
BIT SIZE[6]    TEST[32]: Pre-Image Completed after	76      iterations and collisions completed after	3       iterations
BIT SIZE[6]    TEST[33]: Pre-Image Completed after	29      iterations and collisions completed after	4       iterations
BIT SIZE[6]    TEST[34]: Pre-Image Completed after	3       iterations and collisions completed after	3       iterations
BIT SIZE[6]    TEST[35]: Pre-Image Completed after	26      iterations and collisions completed after	8       iterations
BIT SIZE[6]    TEST[36]: Pre-Image Completed after	16      iterations and collisions completed after	9       iterations
BIT SIZE[6]    TEST[37]: Pre-Image Completed after	18      iterations and collisions completed after	14      iterations
BIT SIZE[6]    TEST[38]: Pre-Image Completed after	41      iterations and collisions completed after	6       iterations
BIT SIZE[6]    TEST[39]: Pre-Image Completed after	49      iterations and collisions completed after	11      iterations
BIT SIZE[6]    TEST[40]: Pre-Image Completed after	15      iterations and collisions completed after	10      iterations
BIT SIZE[6]    TEST[41]: Pre-Image Completed after	4       iterations and collisions completed after	4       iterations
BIT SIZE[6]    TEST[42]: Pre-Image Completed after	22      iterations and collisions completed after	7       iterations
BIT SIZE[6]    TEST[43]: Pre-Image Completed after	32      iterations and collisions completed after	10      iterations
BIT SIZE[6]    TEST[44]: Pre-Image Completed after	77      iterations and collisions completed after	5       iterations
BIT SIZE[6]    TEST[45]: Pre-Image Completed after	2701    iterations and collisions completed after	12      iterations
BIT SIZE[6]    TEST[46]: Pre-Image Completed after	33      iterations and collisions completed after	17      iterations
BIT SIZE[6]    TEST[47]: Pre-Image Completed after	27      iterations and collisions completed after	8       iterations
BIT SIZE[6]    TEST[48]: Pre-Image Completed after	31      iterations and collisions completed after	12      iterations
BIT SIZE[6]    TEST[49]: Pre-Image Completed after	3       iterations and collisions completed after	3       iterations
BIT SIZE[7]    TEST[0]:  Pre-Image Completed after	30      iterations and collisions completed after	13      iterations
BIT SIZE[7]    TEST[1]:  Pre-Image Completed after	36      iterations and collisions completed after	14      iterations
BIT SIZE[7]    TEST[2]:  Pre-Image Completed after	56      iterations and collisions completed after	10      iterations
BIT SIZE[7]    TEST[3]:  Pre-Image Completed after	97      iterations and collisions completed after	17      iterations
BIT SIZE[7]    TEST[4]:  Pre-Image Completed after	180     iterations and collisions completed after	7       iterations
BIT SIZE[7]    TEST[5]:  Pre-Image Completed after	14      iterations and collisions completed after	8       iterations
BIT SIZE[7]    TEST[6]:  Pre-Image Completed after	91      iterations and collisions completed after	20      iterations
BIT SIZE[7]    TEST[7]:  Pre-Image Completed after	25      iterations and collisions completed after	12      iterations
BIT SIZE[7]    TEST[8]:  Pre-Image Completed after	15      iterations and collisions completed after	15      iterations
BIT SIZE[7]    TEST[9]:  Pre-Image Completed after	28      iterations and collisions completed after	10      iterations
BIT SIZE[7]    TEST[10]: Pre-Image Completed after	7       iterations and collisions completed after	7       iterations
BIT SIZE[7]    TEST[11]: Pre-Image Completed after	186     iterations and collisions completed after	11      iterations
BIT SIZE[7]    TEST[12]: Pre-Image Completed after	62      iterations and collisions completed after	5       iterations
BIT SIZE[7]    TEST[13]: Pre-Image Completed after	20      iterations and collisions completed after	13      iterations
BIT SIZE[7]    TEST[14]: Pre-Image Completed after	19      iterations and collisions completed after	12      iterations
BIT SIZE[7]    TEST[15]: Pre-Image Completed after	47      iterations and collisions completed after	15      iterations
BIT SIZE[7]    TEST[16]: Pre-Image Completed after	113     iterations and collisions completed after	7       iterations
BIT SIZE[7]    TEST[17]: Pre-Image Completed after	13      iterations and collisions completed after	12      iterations
BIT SIZE[7]    TEST[18]: Pre-Image Completed after	36      iterations and collisions completed after	3       iterations
BIT SIZE[7]    TEST[19]: Pre-Image Completed after	44      iterations and collisions completed after	14      iterations
BIT SIZE[7]    TEST[20]: Pre-Image Completed after	47      iterations and collisions completed after	12      iterations
BIT SIZE[7]    TEST[21]: Pre-Image Completed after	31      iterations and collisions completed after	7       iterations
BIT SIZE[7]    TEST[22]: Pre-Image Completed after	18      iterations and collisions completed after	3       iterations
BIT SIZE[7]    TEST[23]: Pre-Image Completed after	68      iterations and collisions completed after	11      iterations
BIT SIZE[7]    TEST[24]: Pre-Image Completed after	53      iterations and collisions completed after	11      iterations
BIT SIZE[7]    TEST[25]: Pre-Image Completed after	53      iterations and collisions completed after	17      iterations
BIT SIZE[7]    TEST[26]: Pre-Image Completed after	97      iterations and collisions completed after	9       iterations
BIT SIZE[7]    TEST[27]: Pre-Image Completed after	24      iterations and collisions completed after	12      iterations
BIT SIZE[7]    TEST[28]: Pre-Image Completed after	96      iterations and collisions completed after	10      iterations
BIT SIZE[7]    TEST[29]: Pre-Image Completed after	145     iterations and collisions completed after	18      iterations
BIT SIZE[7]    TEST[30]: Pre-Image Completed after	3       iterations and collisions completed after	3       iterations
BIT SIZE[7]    TEST[31]: Pre-Image Completed after	9       iterations and collisions completed after	6       iterations
BIT SIZE[7]    TEST[32]: Pre-Image Completed after	457     iterations and collisions completed after	6       iterations
BIT SIZE[7]    TEST[33]: Pre-Image Completed after	31      iterations and collisions completed after	16      iterations
BIT SIZE[7]    TEST[34]: Pre-Image Completed after	95      iterations and collisions completed after	14      iterations
BIT SIZE[7]    TEST[35]: Pre-Image Completed after	312     iterations and collisions completed after	16      iterations
BIT SIZE[7]    TEST[36]: Pre-Image Completed after	185     iterations and collisions completed after	16      iterations
BIT SIZE[7]    TEST[37]: Pre-Image Completed after	1       iterations and collisions completed after	1       iterations
BIT SIZE[7]    TEST[38]: Pre-Image Completed after	24      iterations and collisions completed after	4       iterations
BIT SIZE[7]    TEST[39]: Pre-Image Completed after	9       iterations and collisions completed after	9       iterations
BIT SIZE[7]    TEST[40]: Pre-Image Completed after	5       iterations and collisions completed after	5       iterations
BIT SIZE[7]    TEST[41]: Pre-Image Completed after	5       iterations and collisions completed after	5       iterations
BIT SIZE[7]    TEST[42]: Pre-Image Completed after	1       iterations and collisions completed after	1       iterations
BIT SIZE[7]    TEST[43]: Pre-Image Completed after	37      iterations and collisions completed after	20      iterations
BIT SIZE[7]    TEST[44]: Pre-Image Completed after	18      iterations and collisions completed after	10      iterations
BIT SIZE[7]    TEST[45]: Pre-Image Completed after	18      iterations and collisions completed after	6       iterations
BIT SIZE[7]    TEST[46]: Pre-Image Completed after	23      iterations and collisions completed after	9       iterations
BIT SIZE[7]    TEST[47]: Pre-Image Completed after	24      iterations and collisions completed after	12      iterations
BIT SIZE[7]    TEST[48]: Pre-Image Completed after	124     iterations and collisions completed after	7       iterations
BIT SIZE[7]    TEST[49]: Pre-Image Completed after	24      iterations and collisions completed after	6       iterations
BIT SIZE[8]    TEST[0]:  Pre-Image Completed after	28      iterations and collisions completed after	8       iterations
BIT SIZE[8]    TEST[1]:  Pre-Image Completed after	237     iterations and collisions completed after	15      iterations
BIT SIZE[8]    TEST[2]:  Pre-Image Completed after	35      iterations and collisions completed after	24      iterations
BIT SIZE[8]    TEST[3]:  Pre-Image Completed after	35      iterations and collisions completed after	12      iterations
BIT SIZE[8]    TEST[4]:  Pre-Image Completed after	4       iterations and collisions completed after	4       iterations
BIT SIZE[8]    TEST[5]:  Pre-Image Completed after	98      iterations and collisions completed after	12      iterations
BIT SIZE[8]    TEST[6]:  Pre-Image Completed after	45      iterations and collisions completed after	16      iterations
BIT SIZE[8]    TEST[7]:  Pre-Image Completed after	244     iterations and collisions completed after	14      iterations
BIT SIZE[8]    TEST[8]:  Pre-Image Completed after	28      iterations and collisions completed after	4       iterations
BIT SIZE[8]    TEST[9]:  Pre-Image Completed after	31      iterations and collisions completed after	7       iterations
BIT SIZE[8]    TEST[10]: Pre-Image Completed after	13      iterations and collisions completed after	13      iterations
BIT SIZE[8]    TEST[11]: Pre-Image Completed after	81      iterations and collisions completed after	15      iterations
BIT SIZE[8]    TEST[12]: Pre-Image Completed after	273     iterations and collisions completed after	19      iterations
BIT SIZE[8]    TEST[13]: Pre-Image Completed after	78      iterations and collisions completed after	13      iterations
BIT SIZE[8]    TEST[14]: Pre-Image Completed after	607     iterations and collisions completed after	13      iterations
BIT SIZE[8]    TEST[15]: Pre-Image Completed after	29      iterations and collisions completed after	24      iterations
BIT SIZE[8]    TEST[16]: Pre-Image Completed after	281     iterations and collisions completed after	11      iterations
BIT SIZE[8]    TEST[17]: Pre-Image Completed after	1       iterations and collisions completed after	1       iterations
BIT SIZE[8]    TEST[18]: Pre-Image Completed after	50      iterations and collisions completed after	21      iterations
BIT SIZE[8]    TEST[19]: Pre-Image Completed after	25      iterations and collisions completed after	18      iterations
BIT SIZE[8]    TEST[20]: Pre-Image Completed after	12      iterations and collisions completed after	12      iterations
BIT SIZE[8]    TEST[21]: Pre-Image Completed after	55      iterations and collisions completed after	8       iterations
BIT SIZE[8]    TEST[22]: Pre-Image Completed after	7       iterations and collisions completed after	7       iterations
BIT SIZE[8]    TEST[23]: Pre-Image Completed after	85      iterations and collisions completed after	15      iterations
BIT SIZE[8]    TEST[24]: Pre-Image Completed after	211     iterations and collisions completed after	20      iterations
BIT SIZE[8]    TEST[25]: Pre-Image Completed after	93      iterations and collisions completed after	19      iterations
BIT SIZE[8]    TEST[26]: Pre-Image Completed after	6       iterations and collisions completed after	6       iterations
BIT SIZE[8]    TEST[27]: Pre-Image Completed after	7       iterations and collisions completed after	7       iterations
BIT SIZE[8]    TEST[28]: Pre-Image Completed after	212     iterations and collisions completed after	18      iterations
BIT SIZE[8]    TEST[29]: Pre-Image Completed after	69      iterations and collisions completed after	7       iterations
BIT SIZE[8]    TEST[30]: Pre-Image Completed after	1       iterations and collisions completed after	1       iterations
BIT SIZE[8]    TEST[31]: Pre-Image Completed after	67      iterations and collisions completed after	7       iterations
BIT SIZE[8]    TEST[32]: Pre-Image Completed after	31      iterations and collisions completed after	11      iterations
BIT SIZE[8]    TEST[33]: Pre-Image Completed after	10      iterations and collisions completed after	10      iterations
BIT SIZE[8]    TEST[34]: Pre-Image Completed after	153     iterations and collisions completed after	15      iterations
BIT SIZE[8]    TEST[35]: Pre-Image Completed after	167     iterations and collisions completed after	7       iterations
BIT SIZE[8]    TEST[36]: Pre-Image Completed after	359     iterations and collisions completed after	9       iterations
BIT SIZE[8]    TEST[37]: Pre-Image Completed after	237     iterations and collisions completed after	9       iterations
BIT SIZE[8]    TEST[38]: Pre-Image Completed after	38      iterations and collisions completed after	18      iterations
BIT SIZE[8]    TEST[39]: Pre-Image Completed after	116     iterations and collisions completed after	22      iterations
BIT SIZE[8]    TEST[40]: Pre-Image Completed after	41      iterations and collisions completed after	4       iterations
BIT SIZE[8]    TEST[41]: Pre-Image Completed after	117     iterations and collisions completed after	10      iterations
BIT SIZE[8]    TEST[42]: Pre-Image Completed after	334     iterations and collisions completed after	11      iterations
BIT SIZE[8]    TEST[43]: Pre-Image Completed after	30      iterations and collisions completed after	3       iterations
BIT SIZE[8]    TEST[44]: Pre-Image Completed after	44      iterations and collisions completed after	21      iterations
BIT SIZE[8]    TEST[45]: Pre-Image Completed after	56      iterations and collisions completed after	12      iterations
BIT SIZE[8]    TEST[46]: Pre-Image Completed after	13      iterations and collisions completed after	13      iterations
BIT SIZE[8]    TEST[47]: Pre-Image Completed after	68      iterations and collisions completed after	26      iterations
BIT SIZE[8]    TEST[48]: Pre-Image Completed after	27      iterations and collisions completed after	19      iterations
BIT SIZE[8]    TEST[49]: Pre-Image Completed after	130     iterations and collisions completed after	11      iterations
BIT SIZE[9]    TEST[0]:  Pre-Image Completed after	113     iterations and collisions completed after	22      iterations
BIT SIZE[9]    TEST[1]:  Pre-Image Completed after	1337    iterations and collisions completed after	19      iterations
BIT SIZE[9]    TEST[2]:  Pre-Image Completed after	1517    iterations and collisions completed after	24      iterations
BIT SIZE[9]    TEST[3]:  Pre-Image Completed after	271     iterations and collisions completed after	30      iterations
BIT SIZE[9]    TEST[4]:  Pre-Image Completed after	548     iterations and collisions completed after	36      iterations
BIT SIZE[9]    TEST[5]:  Pre-Image Completed after	347     iterations and collisions completed after	9       iterations
BIT SIZE[9]    TEST[6]:  Pre-Image Completed after	154     iterations and collisions completed after	12      iterations
BIT SIZE[9]    TEST[7]:  Pre-Image Completed after	187     iterations and collisions completed after	18      iterations
BIT SIZE[9]    TEST[8]:  Pre-Image Completed after	218     iterations and collisions completed after	24      iterations
BIT SIZE[9]    TEST[9]:  Pre-Image Completed after	33      iterations and collisions completed after	10      iterations
BIT SIZE[9]    TEST[10]: Pre-Image Completed after	18      iterations and collisions completed after	14      iterations
BIT SIZE[9]    TEST[11]: Pre-Image Completed after	407     iterations and collisions completed after	21      iterations
BIT SIZE[9]    TEST[12]: Pre-Image Completed after	42      iterations and collisions completed after	11      iterations
BIT SIZE[9]    TEST[13]: Pre-Image Completed after	117     iterations and collisions completed after	14      iterations
BIT SIZE[9]    TEST[14]: Pre-Image Completed after	2243    iterations and collisions completed after	36      iterations
BIT SIZE[9]    TEST[15]: Pre-Image Completed after	191     iterations and collisions completed after	6       iterations
BIT SIZE[9]    TEST[16]: Pre-Image Completed after	159     iterations and collisions completed after	26      iterations
BIT SIZE[9]    TEST[17]: Pre-Image Completed after	3       iterations and collisions completed after	3       iterations
BIT SIZE[9]    TEST[18]: Pre-Image Completed after	105     iterations and collisions completed after	17      iterations
BIT SIZE[9]    TEST[19]: Pre-Image Completed after	38      iterations and collisions completed after	29      iterations
BIT SIZE[9]    TEST[20]: Pre-Image Completed after	191     iterations and collisions completed after	17      iterations
BIT SIZE[9]    TEST[21]: Pre-Image Completed after	1117    iterations and collisions completed after	7       iterations
BIT SIZE[9]    TEST[22]: Pre-Image Completed after	40      iterations and collisions completed after	28      iterations
BIT SIZE[9]    TEST[23]: Pre-Image Completed after	1661    iterations and collisions completed after	12      iterations
BIT SIZE[9]    TEST[24]: Pre-Image Completed after	84      iterations and collisions completed after	7       iterations
BIT SIZE[9]    TEST[25]: Pre-Image Completed after	195     iterations and collisions completed after	11      iterations
BIT SIZE[9]    TEST[26]: Pre-Image Completed after	371     iterations and collisions completed after	11      iterations
BIT SIZE[9]    TEST[27]: Pre-Image Completed after	50      iterations and collisions completed after	2       iterations
BIT SIZE[9]    TEST[28]: Pre-Image Completed after	59      iterations and collisions completed after	16      iterations
BIT SIZE[9]    TEST[29]: Pre-Image Completed after	105     iterations and collisions completed after	13      iterations
BIT SIZE[9]    TEST[30]: Pre-Image Completed after	38      iterations and collisions completed after	5       iterations
BIT SIZE[9]    TEST[31]: Pre-Image Completed after	43      iterations and collisions completed after	10      iterations
BIT SIZE[9]    TEST[32]: Pre-Image Completed after	222     iterations and collisions completed after	28      iterations
BIT SIZE[9]    TEST[33]: Pre-Image Completed after	131     iterations and collisions completed after	14      iterations
BIT SIZE[9]    TEST[34]: Pre-Image Completed after	381     iterations and collisions completed after	20      iterations
BIT SIZE[9]    TEST[35]: Pre-Image Completed after	158     iterations and collisions completed after	15      iterations
BIT SIZE[9]    TEST[36]: Pre-Image Completed after	54      iterations and collisions completed after	32      iterations
BIT SIZE[9]    TEST[37]: Pre-Image Completed after	240     iterations and collisions completed after	21      iterations
BIT SIZE[9]    TEST[38]: Pre-Image Completed after	84      iterations and collisions completed after	20      iterations
BIT SIZE[9]    TEST[39]: Pre-Image Completed after	756     iterations and collisions completed after	27      iterations
BIT SIZE[9]    TEST[40]: Pre-Image Completed after	85      iterations and collisions completed after	27      iterations
BIT SIZE[9]    TEST[41]: Pre-Image Completed after	402     iterations and collisions completed after	17      iterations
BIT SIZE[9]    TEST[42]: Pre-Image Completed after	26      iterations and collisions completed after	13      iterations
BIT SIZE[9]    TEST[43]: Pre-Image Completed after	54      iterations and collisions completed after	14      iterations
BIT SIZE[9]    TEST[44]: Pre-Image Completed after	20      iterations and collisions completed after	20      iterations
BIT SIZE[9]    TEST[45]: Pre-Image Completed after	39      iterations and collisions completed after	22      iterations
BIT SIZE[9]    TEST[46]: Pre-Image Completed after	33      iterations and collisions completed after	15      iterations
BIT SIZE[9]    TEST[47]: Pre-Image Completed after	19      iterations and collisions completed after	19      iterations
BIT SIZE[9]    TEST[48]: Pre-Image Completed after	168     iterations and collisions completed after	24      iterations
BIT SIZE[9]    TEST[49]: Pre-Image Completed after	1041    iterations and collisions completed after	8       iterations
BIT SIZE[10]   TEST[0]:  Pre-Image Completed after	334     iterations and collisions completed after	21      iterations
BIT SIZE[10]   TEST[1]:  Pre-Image Completed after	471     iterations and collisions completed after	18      iterations
BIT SIZE[10]   TEST[2]:  Pre-Image Completed after	133     iterations and collisions completed after	48      iterations
BIT SIZE[10]   TEST[3]:  Pre-Image Completed after	514     iterations and collisions completed after	4       iterations
BIT SIZE[10]   TEST[4]:  Pre-Image Completed after	29      iterations and collisions completed after	17      iterations
BIT SIZE[10]   TEST[5]:  Pre-Image Completed after	288     iterations and collisions completed after	23      iterations
BIT SIZE[10]   TEST[6]:  Pre-Image Completed after	483     iterations and collisions completed after	17      iterations
BIT SIZE[10]   TEST[7]:  Pre-Image Completed after	36      iterations and collisions completed after	36      iterations
BIT SIZE[10]   TEST[8]:  Pre-Image Completed after	532     iterations and collisions completed after	26      iterations
BIT SIZE[10]   TEST[9]:  Pre-Image Completed after	1381    iterations and collisions completed after	24      iterations
BIT SIZE[10]   TEST[10]: Pre-Image Completed after	232     iterations and collisions completed after	28      iterations
BIT SIZE[10]   TEST[11]: Pre-Image Completed after	763     iterations and collisions completed after	27      iterations
BIT SIZE[10]   TEST[12]: Pre-Image Completed after	489     iterations and collisions completed after	5       iterations
BIT SIZE[10]   TEST[13]: Pre-Image Completed after	494     iterations and collisions completed after	25      iterations
BIT SIZE[10]   TEST[14]: Pre-Image Completed after	39      iterations and collisions completed after	23      iterations
BIT SIZE[10]   TEST[15]: Pre-Image Completed after	286     iterations and collisions completed after	13      iterations
BIT SIZE[10]   TEST[16]: Pre-Image Completed after	489     iterations and collisions completed after	25      iterations
BIT SIZE[10]   TEST[17]: Pre-Image Completed after	804     iterations and collisions completed after	23      iterations
BIT SIZE[10]   TEST[18]: Pre-Image Completed after	717     iterations and collisions completed after	30      iterations
BIT SIZE[10]   TEST[19]: Pre-Image Completed after	216     iterations and collisions completed after	23      iterations
BIT SIZE[10]   TEST[20]: Pre-Image Completed after	96      iterations and collisions completed after	11      iterations
BIT SIZE[10]   TEST[21]: Pre-Image Completed after	173     iterations and collisions completed after	29      iterations
BIT SIZE[10]   TEST[22]: Pre-Image Completed after	614     iterations and collisions completed after	22      iterations
BIT SIZE[10]   TEST[23]: Pre-Image Completed after	998     iterations and collisions completed after	51      iterations
BIT SIZE[10]   TEST[24]: Pre-Image Completed after	4741    iterations and collisions completed after	33      iterations
BIT SIZE[10]   TEST[25]: Pre-Image Completed after	785     iterations and collisions completed after	29      iterations
BIT SIZE[10]   TEST[26]: Pre-Image Completed after	26      iterations and collisions completed after	17      iterations
BIT SIZE[10]   TEST[27]: Pre-Image Completed after	212     iterations and collisions completed after	47      iterations
BIT SIZE[10]   TEST[28]: Pre-Image Completed after	225     iterations and collisions completed after	40      iterations
BIT SIZE[10]   TEST[29]: Pre-Image Completed after	265     iterations and collisions completed after	13      iterations
BIT SIZE[10]   TEST[30]: Pre-Image Completed after	34      iterations and collisions completed after	30      iterations
BIT SIZE[10]   TEST[31]: Pre-Image Completed after	862     iterations and collisions completed after	25      iterations
BIT SIZE[10]   TEST[32]: Pre-Image Completed after	1377    iterations and collisions completed after	19      iterations
BIT SIZE[10]   TEST[33]: Pre-Image Completed after	548     iterations and collisions completed after	23      iterations
BIT SIZE[10]   TEST[34]: Pre-Image Completed after	910     iterations and collisions completed after	39      iterations
BIT SIZE[10]   TEST[35]: Pre-Image Completed after	340     iterations and collisions completed after	31      iterations
BIT SIZE[10]   TEST[36]: Pre-Image Completed after	112     iterations and collisions completed after	45      iterations
BIT SIZE[10]   TEST[37]: Pre-Image Completed after	355     iterations and collisions completed after	27      iterations
BIT SIZE[10]   TEST[38]: Pre-Image Completed after	187     iterations and collisions completed after	7       iterations
BIT SIZE[10]   TEST[39]: Pre-Image Completed after	461     iterations and collisions completed after	34      iterations
BIT SIZE[10]   TEST[40]: Pre-Image Completed after	389     iterations and collisions completed after	65      iterations
BIT SIZE[10]   TEST[41]: Pre-Image Completed after	57      iterations and collisions completed after	25      iterations
BIT SIZE[10]   TEST[42]: Pre-Image Completed after	490     iterations and collisions completed after	11      iterations
BIT SIZE[10]   TEST[43]: Pre-Image Completed after	41      iterations and collisions completed after	41      iterations
BIT SIZE[10]   TEST[44]: Pre-Image Completed after	482     iterations and collisions completed after	21      iterations
BIT SIZE[10]   TEST[45]: Pre-Image Completed after	78      iterations and collisions completed after	35      iterations
BIT SIZE[10]   TEST[46]: Pre-Image Completed after	273     iterations and collisions completed after	18      iterations
BIT SIZE[10]   TEST[47]: Pre-Image Completed after	116     iterations and collisions completed after	18      iterations
BIT SIZE[10]   TEST[48]: Pre-Image Completed after	1150    iterations and collisions completed after	65      iterations
BIT SIZE[10]   TEST[49]: Pre-Image Completed after	100     iterations and collisions completed after	14      iterations
BIT SIZE[11]   TEST[0]:  Pre-Image Completed after	2634    iterations and collisions completed after	32      iterations
BIT SIZE[11]   TEST[1]:  Pre-Image Completed after	357     iterations and collisions completed after	34      iterations
BIT SIZE[11]   TEST[2]:  Pre-Image Completed after	880     iterations and collisions completed after	24      iterations
BIT SIZE[11]   TEST[3]:  Pre-Image Completed after	1145    iterations and collisions completed after	58      iterations
BIT SIZE[11]   TEST[4]:  Pre-Image Completed after	2513    iterations and collisions completed after	15      iterations
BIT SIZE[11]   TEST[5]:  Pre-Image Completed after	3950    iterations and collisions completed after	61      iterations
BIT SIZE[11]   TEST[6]:  Pre-Image Completed after	16      iterations and collisions completed after	16      iterations
BIT SIZE[11]   TEST[7]:  Pre-Image Completed after	758     iterations and collisions completed after	43      iterations
BIT SIZE[11]   TEST[8]:  Pre-Image Completed after	1364    iterations and collisions completed after	21      iterations
BIT SIZE[11]   TEST[9]:  Pre-Image Completed after	6447    iterations and collisions completed after	26      iterations
BIT SIZE[11]   TEST[10]: Pre-Image Completed after	2039    iterations and collisions completed after	22      iterations
BIT SIZE[11]   TEST[11]: Pre-Image Completed after	3802    iterations and collisions completed after	46      iterations
BIT SIZE[11]   TEST[12]: Pre-Image Completed after	32      iterations and collisions completed after	32      iterations
BIT SIZE[11]   TEST[13]: Pre-Image Completed after	739     iterations and collisions completed after	34      iterations
BIT SIZE[11]   TEST[14]: Pre-Image Completed after	1173    iterations and collisions completed after	48      iterations
BIT SIZE[11]   TEST[15]: Pre-Image Completed after	840     iterations and collisions completed after	75      iterations
BIT SIZE[11]   TEST[16]: Pre-Image Completed after	140     iterations and collisions completed after	69      iterations
BIT SIZE[11]   TEST[17]: Pre-Image Completed after	313     iterations and collisions completed after	29      iterations
BIT SIZE[11]   TEST[18]: Pre-Image Completed after	978     iterations and collisions completed after	67      iterations
BIT SIZE[11]   TEST[19]: Pre-Image Completed after	3064    iterations and collisions completed after	30      iterations
BIT SIZE[11]   TEST[20]: Pre-Image Completed after	544     iterations and collisions completed after	35      iterations
BIT SIZE[11]   TEST[21]: Pre-Image Completed after	67      iterations and collisions completed after	59      iterations
BIT SIZE[11]   TEST[22]: Pre-Image Completed after	177     iterations and collisions completed after	20      iterations
BIT SIZE[11]   TEST[23]: Pre-Image Completed after	546     iterations and collisions completed after	53      iterations
BIT SIZE[11]   TEST[24]: Pre-Image Completed after	1423    iterations and collisions completed after	23      iterations
BIT SIZE[11]   TEST[25]: Pre-Image Completed after	3137    iterations and collisions completed after	26      iterations
BIT SIZE[11]   TEST[26]: Pre-Image Completed after	52      iterations and collisions completed after	39      iterations
BIT SIZE[11]   TEST[27]: Pre-Image Completed after	842     iterations and collisions completed after	31      iterations
BIT SIZE[11]   TEST[28]: Pre-Image Completed after	599     iterations and collisions completed after	45      iterations
BIT SIZE[11]   TEST[29]: Pre-Image Completed after	1229    iterations and collisions completed after	14      iterations
BIT SIZE[11]   TEST[30]: Pre-Image Completed after	531     iterations and collisions completed after	38      iterations
BIT SIZE[11]   TEST[31]: Pre-Image Completed after	1783    iterations and collisions completed after	36      iterations
BIT SIZE[11]   TEST[32]: Pre-Image Completed after	1543    iterations and collisions completed after	77      iterations
BIT SIZE[11]   TEST[33]: Pre-Image Completed after	2487    iterations and collisions completed after	16      iterations
BIT SIZE[11]   TEST[34]: Pre-Image Completed after	31      iterations and collisions completed after	31      iterations
BIT SIZE[11]   TEST[35]: Pre-Image Completed after	157     iterations and collisions completed after	35      iterations
BIT SIZE[11]   TEST[36]: Pre-Image Completed after	324     iterations and collisions completed after	47      iterations
BIT SIZE[11]   TEST[37]: Pre-Image Completed after	1889    iterations and collisions completed after	32      iterations
BIT SIZE[11]   TEST[38]: Pre-Image Completed after	568     iterations and collisions completed after	42      iterations
BIT SIZE[11]   TEST[39]: Pre-Image Completed after	501     iterations and collisions completed after	17      iterations
BIT SIZE[11]   TEST[40]: Pre-Image Completed after	120     iterations and collisions completed after	42      iterations
BIT SIZE[11]   TEST[41]: Pre-Image Completed after	95      iterations and collisions completed after	15      iterations
BIT SIZE[11]   TEST[42]: Pre-Image Completed after	1446    iterations and collisions completed after	11      iterations
BIT SIZE[11]   TEST[43]: Pre-Image Completed after	85      iterations and collisions completed after	10      iterations
BIT SIZE[11]   TEST[44]: Pre-Image Completed after	338     iterations and collisions completed after	58      iterations
BIT SIZE[11]   TEST[45]: Pre-Image Completed after	751     iterations and collisions completed after	39      iterations
BIT SIZE[11]   TEST[46]: Pre-Image Completed after	22      iterations and collisions completed after	17      iterations
BIT SIZE[11]   TEST[47]: Pre-Image Completed after	347     iterations and collisions completed after	34      iterations
BIT SIZE[11]   TEST[48]: Pre-Image Completed after	985     iterations and collisions completed after	22      iterations
BIT SIZE[11]   TEST[49]: Pre-Image Completed after	724     iterations and collisions completed after	63      iterations
BIT SIZE[12]   TEST[0]:  Pre-Image Completed after	181     iterations and collisions completed after	74      iterations
BIT SIZE[12]   TEST[1]:  Pre-Image Completed after	1338    iterations and collisions completed after	50      iterations
BIT SIZE[12]   TEST[2]:  Pre-Image Completed after	296     iterations and collisions completed after	39      iterations
BIT SIZE[12]   TEST[3]:  Pre-Image Completed after	2183    iterations and collisions completed after	70      iterations
BIT SIZE[12]   TEST[4]:  Pre-Image Completed after	1512    iterations and collisions completed after	34      iterations
BIT SIZE[12]   TEST[5]:  Pre-Image Completed after	21310   iterations and collisions completed after	60      iterations
BIT SIZE[12]   TEST[6]:  Pre-Image Completed after	199     iterations and collisions completed after	98      iterations
BIT SIZE[12]   TEST[7]:  Pre-Image Completed after	2654    iterations and collisions completed after	31      iterations
BIT SIZE[12]   TEST[8]:  Pre-Image Completed after	3209    iterations and collisions completed after	78      iterations
BIT SIZE[12]   TEST[9]:  Pre-Image Completed after	354     iterations and collisions completed after	63      iterations
BIT SIZE[12]   TEST[10]: Pre-Image Completed after	2574    iterations and collisions completed after	115     iterations
BIT SIZE[12]   TEST[11]: Pre-Image Completed after	1046    iterations and collisions completed after	6       iterations
BIT SIZE[12]   TEST[12]: Pre-Image Completed after	1982    iterations and collisions completed after	59      iterations
BIT SIZE[12]   TEST[13]: Pre-Image Completed after	3173    iterations and collisions completed after	26      iterations
BIT SIZE[12]   TEST[14]: Pre-Image Completed after	355     iterations and collisions completed after	34      iterations
BIT SIZE[12]   TEST[15]: Pre-Image Completed after	6602    iterations and collisions completed after	19      iterations
BIT SIZE[12]   TEST[16]: Pre-Image Completed after	3464    iterations and collisions completed after	48      iterations
BIT SIZE[12]   TEST[17]: Pre-Image Completed after	636     iterations and collisions completed after	78      iterations
BIT SIZE[12]   TEST[18]: Pre-Image Completed after	3177    iterations and collisions completed after	109     iterations
BIT SIZE[12]   TEST[19]: Pre-Image Completed after	2362    iterations and collisions completed after	51      iterations
BIT SIZE[12]   TEST[20]: Pre-Image Completed after	10132   iterations and collisions completed after	28      iterations
BIT SIZE[12]   TEST[21]: Pre-Image Completed after	2289    iterations and collisions completed after	41      iterations
BIT SIZE[12]   TEST[22]: Pre-Image Completed after	876     iterations and collisions completed after	48      iterations
BIT SIZE[12]   TEST[23]: Pre-Image Completed after	594     iterations and collisions completed after	27      iterations
BIT SIZE[12]   TEST[24]: Pre-Image Completed after	247     iterations and collisions completed after	25      iterations
BIT SIZE[12]   TEST[25]: Pre-Image Completed after	9745    iterations and collisions completed after	24      iterations
BIT SIZE[12]   TEST[26]: Pre-Image Completed after	2748    iterations and collisions completed after	88      iterations
BIT SIZE[12]   TEST[27]: Pre-Image Completed after	597     iterations and collisions completed after	35      iterations
BIT SIZE[12]   TEST[28]: Pre-Image Completed after	21759   iterations and collisions completed after	42      iterations
BIT SIZE[12]   TEST[29]: Pre-Image Completed after	223     iterations and collisions completed after	9       iterations
BIT SIZE[12]   TEST[30]: Pre-Image Completed after	18386   iterations and collisions completed after	30      iterations
BIT SIZE[12]   TEST[31]: Pre-Image Completed after	2905    iterations and collisions completed after	35      iterations
BIT SIZE[12]   TEST[32]: Pre-Image Completed after	2590    iterations and collisions completed after	37      iterations
BIT SIZE[12]   TEST[33]: Pre-Image Completed after	2257    iterations and collisions completed after	45      iterations
BIT SIZE[12]   TEST[34]: Pre-Image Completed after	4563    iterations and collisions completed after	28      iterations
BIT SIZE[12]   TEST[35]: Pre-Image Completed after	3155    iterations and collisions completed after	81      iterations
BIT SIZE[12]   TEST[36]: Pre-Image Completed after	788     iterations and collisions completed after	69      iterations
BIT SIZE[12]   TEST[37]: Pre-Image Completed after	1195    iterations and collisions completed after	8       iterations
BIT SIZE[12]   TEST[38]: Pre-Image Completed after	70      iterations and collisions completed after	70      iterations
BIT SIZE[12]   TEST[39]: Pre-Image Completed after	478     iterations and collisions completed after	25      iterations
BIT SIZE[12]   TEST[40]: Pre-Image Completed after	1585    iterations and collisions completed after	33      iterations
BIT SIZE[12]   TEST[41]: Pre-Image Completed after	329     iterations and collisions completed after	33      iterations
BIT SIZE[12]   TEST[42]: Pre-Image Completed after	1827    iterations and collisions completed after	37      iterations
BIT SIZE[12]   TEST[43]: Pre-Image Completed after	3847    iterations and collisions completed after	41      iterations
BIT SIZE[12]   TEST[44]: Pre-Image Completed after	3577    iterations and collisions completed after	38      iterations
BIT SIZE[12]   TEST[45]: Pre-Image Completed after	167     iterations and collisions completed after	64      iterations
BIT SIZE[12]   TEST[46]: Pre-Image Completed after	409     iterations and collisions completed after	51      iterations
BIT SIZE[12]   TEST[47]: Pre-Image Completed after	62621   iterations and collisions completed after	3       iterations
BIT SIZE[12]   TEST[48]: Pre-Image Completed after	890     iterations and collisions completed after	22      iterations
BIT SIZE[12]   TEST[49]: Pre-Image Completed after	488     iterations and collisions completed after	85      iterations
BIT SIZE[13]   TEST[0]:  Pre-Image Completed after	992     iterations and collisions completed after	148     iterations
BIT SIZE[13]   TEST[1]:  Pre-Image Completed after	358     iterations and collisions completed after	18      iterations
BIT SIZE[13]   TEST[2]:  Pre-Image Completed after	538     iterations and collisions completed after	31      iterations
BIT SIZE[13]   TEST[3]:  Pre-Image Completed after	4949    iterations and collisions completed after	70      iterations
BIT SIZE[13]   TEST[4]:  Pre-Image Completed after	8252    iterations and collisions completed after	50      iterations
BIT SIZE[13]   TEST[5]:  Pre-Image Completed after	495     iterations and collisions completed after	150     iterations
BIT SIZE[13]   TEST[6]:  Pre-Image Completed after	6344    iterations and collisions completed after	22      iterations
BIT SIZE[13]   TEST[7]:  Pre-Image Completed after	443     iterations and collisions completed after	67      iterations
BIT SIZE[13]   TEST[8]:  Pre-Image Completed after	9404    iterations and collisions completed after	108     iterations
BIT SIZE[13]   TEST[9]:  Pre-Image Completed after	2218    iterations and collisions completed after	65      iterations
BIT SIZE[13]   TEST[10]: Pre-Image Completed after	11802   iterations and collisions completed after	42      iterations
BIT SIZE[13]   TEST[11]: Pre-Image Completed after	2415    iterations and collisions completed after	80      iterations
BIT SIZE[13]   TEST[12]: Pre-Image Completed after	862     iterations and collisions completed after	59      iterations
BIT SIZE[13]   TEST[13]: Pre-Image Completed after	1863    iterations and collisions completed after	120     iterations
BIT SIZE[13]   TEST[14]: Pre-Image Completed after	424     iterations and collisions completed after	118     iterations
BIT SIZE[13]   TEST[15]: Pre-Image Completed after	1405    iterations and collisions completed after	54      iterations
BIT SIZE[13]   TEST[16]: Pre-Image Completed after	2389    iterations and collisions completed after	78      iterations
BIT SIZE[13]   TEST[17]: Pre-Image Completed after	15686   iterations and collisions completed after	58      iterations
BIT SIZE[13]   TEST[18]: Pre-Image Completed after	2527    iterations and collisions completed after	90      iterations
BIT SIZE[13]   TEST[19]: Pre-Image Completed after	693     iterations and collisions completed after	68      iterations
BIT SIZE[13]   TEST[20]: Pre-Image Completed after	9116    iterations and collisions completed after	67      iterations
BIT SIZE[13]   TEST[21]: Pre-Image Completed after	14483   iterations and collisions completed after	41      iterations
BIT SIZE[13]   TEST[22]: Pre-Image Completed after	655     iterations and collisions completed after	15      iterations
BIT SIZE[13]   TEST[23]: Pre-Image Completed after	3688    iterations and collisions completed after	107     iterations
BIT SIZE[13]   TEST[24]: Pre-Image Completed after	1420    iterations and collisions completed after	78      iterations
BIT SIZE[13]   TEST[25]: Pre-Image Completed after	590     iterations and collisions completed after	208     iterations
BIT SIZE[13]   TEST[26]: Pre-Image Completed after	2182    iterations and collisions completed after	26      iterations
BIT SIZE[13]   TEST[27]: Pre-Image Completed after	32690   iterations and collisions completed after	60      iterations
BIT SIZE[13]   TEST[28]: Pre-Image Completed after	6403    iterations and collisions completed after	51      iterations
BIT SIZE[13]   TEST[29]: Pre-Image Completed after	2496    iterations and collisions completed after	91      iterations
BIT SIZE[13]   TEST[30]: Pre-Image Completed after	1387    iterations and collisions completed after	42      iterations
BIT SIZE[13]   TEST[31]: Pre-Image Completed after	998     iterations and collisions completed after	7       iterations
BIT SIZE[13]   TEST[32]: Pre-Image Completed after	15234   iterations and collisions completed after	50      iterations
BIT SIZE[13]   TEST[33]: Pre-Image Completed after	3159    iterations and collisions completed after	47      iterations
BIT SIZE[13]   TEST[34]: Pre-Image Completed after	942     iterations and collisions completed after	122     iterations
BIT SIZE[13]   TEST[35]: Pre-Image Completed after	841     iterations and collisions completed after	61      iterations
BIT SIZE[13]   TEST[36]: Pre-Image Completed after	2677    iterations and collisions completed after	49      iterations
BIT SIZE[13]   TEST[37]: Pre-Image Completed after	436     iterations and collisions completed after	143     iterations
BIT SIZE[13]   TEST[38]: Pre-Image Completed after	241     iterations and collisions completed after	93      iterations
BIT SIZE[13]   TEST[39]: Pre-Image Completed after	2019    iterations and collisions completed after	71      iterations
BIT SIZE[13]   TEST[40]: Pre-Image Completed after	911     iterations and collisions completed after	48      iterations
BIT SIZE[13]   TEST[41]: Pre-Image Completed after	1077    iterations and collisions completed after	54      iterations
BIT SIZE[13]   TEST[42]: Pre-Image Completed after	1938    iterations and collisions completed after	12      iterations
BIT SIZE[13]   TEST[43]: Pre-Image Completed after	1812    iterations and collisions completed after	70      iterations
BIT SIZE[13]   TEST[44]: Pre-Image Completed after	3984    iterations and collisions completed after	78      iterations
BIT SIZE[13]   TEST[45]: Pre-Image Completed after	3064    iterations and collisions completed after	106     iterations
BIT SIZE[13]   TEST[46]: Pre-Image Completed after	2305    iterations and collisions completed after	79      iterations
BIT SIZE[13]   TEST[47]: Pre-Image Completed after	2776    iterations and collisions completed after	115     iterations
BIT SIZE[13]   TEST[48]: Pre-Image Completed after	5913    iterations and collisions completed after	51      iterations
BIT SIZE[13]   TEST[49]: Pre-Image Completed after	617     iterations and collisions completed after	46      iterations
BIT SIZE[14]   TEST[0]:  Pre-Image Completed after	12503   iterations and collisions completed after	126     iterations
BIT SIZE[14]   TEST[1]:  Pre-Image Completed after	85      iterations and collisions completed after	57      iterations
BIT SIZE[14]   TEST[2]:  Pre-Image Completed after	1758    iterations and collisions completed after	162     iterations
BIT SIZE[14]   TEST[3]:  Pre-Image Completed after	11735   iterations and collisions completed after	47      iterations
BIT SIZE[14]   TEST[4]:  Pre-Image Completed after	21821   iterations and collisions completed after	126     iterations
BIT SIZE[14]   TEST[5]:  Pre-Image Completed after	6164    iterations and collisions completed after	61      iterations
BIT SIZE[14]   TEST[6]:  Pre-Image Completed after	8126    iterations and collisions completed after	102     iterations
BIT SIZE[14]   TEST[7]:  Pre-Image Completed after	1735    iterations and collisions completed after	95      iterations
BIT SIZE[14]   TEST[8]:  Pre-Image Completed after	5542    iterations and collisions completed after	52      iterations
BIT SIZE[14]   TEST[9]:  Pre-Image Completed after	1078    iterations and collisions completed after	124     iterations
BIT SIZE[14]   TEST[10]: Pre-Image Completed after	2398    iterations and collisions completed after	114     iterations
BIT SIZE[14]   TEST[11]: Pre-Image Completed after	2170    iterations and collisions completed after	87      iterations
BIT SIZE[14]   TEST[12]: Pre-Image Completed after	21832   iterations and collisions completed after	110     iterations
BIT SIZE[14]   TEST[13]: Pre-Image Completed after	11513   iterations and collisions completed after	56      iterations
BIT SIZE[14]   TEST[14]: Pre-Image Completed after	368     iterations and collisions completed after	98      iterations
BIT SIZE[14]   TEST[15]: Pre-Image Completed after	10113   iterations and collisions completed after	66      iterations
BIT SIZE[14]   TEST[16]: Pre-Image Completed after	15778   iterations and collisions completed after	54      iterations
BIT SIZE[14]   TEST[17]: Pre-Image Completed after	4932    iterations and collisions completed after	46      iterations
BIT SIZE[14]   TEST[18]: Pre-Image Completed after	2018    iterations and collisions completed after	129     iterations
BIT SIZE[14]   TEST[19]: Pre-Image Completed after	16678   iterations and collisions completed after	131     iterations
BIT SIZE[14]   TEST[20]: Pre-Image Completed after	94      iterations and collisions completed after	79      iterations
BIT SIZE[14]   TEST[21]: Pre-Image Completed after	20373   iterations and collisions completed after	57      iterations
BIT SIZE[14]   TEST[22]: Pre-Image Completed after	348     iterations and collisions completed after	156     iterations
BIT SIZE[14]   TEST[23]: Pre-Image Completed after	6848    iterations and collisions completed after	105     iterations
BIT SIZE[14]   TEST[24]: Pre-Image Completed after	14710   iterations and collisions completed after	182     iterations
BIT SIZE[14]   TEST[25]: Pre-Image Completed after	437     iterations and collisions completed after	110     iterations
BIT SIZE[14]   TEST[26]: Pre-Image Completed after	16614   iterations and collisions completed after	76      iterations
BIT SIZE[14]   TEST[27]: Pre-Image Completed after	5503    iterations and collisions completed after	19      iterations
BIT SIZE[14]   TEST[28]: Pre-Image Completed after	6408    iterations and collisions completed after	25      iterations
BIT SIZE[14]   TEST[29]: Pre-Image Completed after	2437    iterations and collisions completed after	14      iterations
BIT SIZE[14]   TEST[30]: Pre-Image Completed after	6998    iterations and collisions completed after	98      iterations
BIT SIZE[14]   TEST[31]: Pre-Image Completed after	13665   iterations and collisions completed after	112     iterations
BIT SIZE[14]   TEST[32]: Pre-Image Completed after	1925    iterations and collisions completed after	104     iterations
BIT SIZE[14]   TEST[33]: Pre-Image Completed after	22484   iterations and collisions completed after	146     iterations
BIT SIZE[14]   TEST[34]: Pre-Image Completed after	3699    iterations and collisions completed after	53      iterations
BIT SIZE[14]   TEST[35]: Pre-Image Completed after	940     iterations and collisions completed after	131     iterations
BIT SIZE[14]   TEST[36]: Pre-Image Completed after	269     iterations and collisions completed after	39      iterations
BIT SIZE[14]   TEST[37]: Pre-Image Completed after	8034    iterations and collisions completed after	150     iterations
BIT SIZE[14]   TEST[38]: Pre-Image Completed after	2614    iterations and collisions completed after	114     iterations
BIT SIZE[14]   TEST[39]: Pre-Image Completed after	14050   iterations and collisions completed after	112     iterations
BIT SIZE[14]   TEST[40]: Pre-Image Completed after	3445    iterations and collisions completed after	73      iterations
BIT SIZE[14]   TEST[41]: Pre-Image Completed after	854     iterations and collisions completed after	25      iterations
BIT SIZE[14]   TEST[42]: Pre-Image Completed after	4208    iterations and collisions completed after	54      iterations
BIT SIZE[14]   TEST[43]: Pre-Image Completed after	292     iterations and collisions completed after	82      iterations
BIT SIZE[14]   TEST[44]: Pre-Image Completed after	2290    iterations and collisions completed after	55      iterations
BIT SIZE[14]   TEST[45]: Pre-Image Completed after	6234    iterations and collisions completed after	233     iterations
BIT SIZE[14]   TEST[46]: Pre-Image Completed after	4019    iterations and collisions completed after	75      iterations
BIT SIZE[14]   TEST[47]: Pre-Image Completed after	8109    iterations and collisions completed after	105     iterations
BIT SIZE[14]   TEST[48]: Pre-Image Completed after	15787   iterations and collisions completed after	167     iterations
BIT SIZE[14]   TEST[49]: Pre-Image Completed after	6152    iterations and collisions completed after	165     iterations
BIT SIZE[15]   TEST[0]:  Pre-Image Completed after	6849    iterations and collisions completed after	57      iterations
BIT SIZE[15]   TEST[1]:  Pre-Image Completed after	21248   iterations and collisions completed after	188     iterations
BIT SIZE[15]   TEST[2]:  Pre-Image Completed after	1610    iterations and collisions completed after	169     iterations
BIT SIZE[15]   TEST[3]:  Pre-Image Completed after	16293   iterations and collisions completed after	101     iterations
BIT SIZE[15]   TEST[4]:  Pre-Image Completed after	4353    iterations and collisions completed after	59      iterations
BIT SIZE[15]   TEST[5]:  Pre-Image Completed after	13702   iterations and collisions completed after	45      iterations
BIT SIZE[15]   TEST[6]:  Pre-Image Completed after	36996   iterations and collisions completed after	61      iterations
BIT SIZE[15]   TEST[7]:  Pre-Image Completed after	6174    iterations and collisions completed after	34      iterations
BIT SIZE[15]   TEST[8]:  Pre-Image Completed after	11390   iterations and collisions completed after	75      iterations
BIT SIZE[15]   TEST[9]:  Pre-Image Completed after	3221    iterations and collisions completed after	55      iterations
BIT SIZE[15]   TEST[10]: Pre-Image Completed after	14114   iterations and collisions completed after	40      iterations
BIT SIZE[15]   TEST[11]: Pre-Image Completed after	106331  iterations and collisions completed after	42      iterations
BIT SIZE[15]   TEST[12]: Pre-Image Completed after	5929    iterations and collisions completed after	56      iterations
BIT SIZE[15]   TEST[13]: Pre-Image Completed after	4864    iterations and collisions completed after	55      iterations
BIT SIZE[15]   TEST[14]: Pre-Image Completed after	17686   iterations and collisions completed after	113     iterations
BIT SIZE[15]   TEST[15]: Pre-Image Completed after	2100    iterations and collisions completed after	118     iterations
BIT SIZE[15]   TEST[16]: Pre-Image Completed after	646     iterations and collisions completed after	74      iterations
BIT SIZE[15]   TEST[17]: Pre-Image Completed after	14880   iterations and collisions completed after	84      iterations
BIT SIZE[15]   TEST[18]: Pre-Image Completed after	2410    iterations and collisions completed after	138     iterations
BIT SIZE[15]   TEST[19]: Pre-Image Completed after	1697    iterations and collisions completed after	133     iterations
BIT SIZE[15]   TEST[20]: Pre-Image Completed after	139871  iterations and collisions completed after	161     iterations
BIT SIZE[15]   TEST[21]: Pre-Image Completed after	2297    iterations and collisions completed after	93      iterations
BIT SIZE[15]   TEST[22]: Pre-Image Completed after	7768    iterations and collisions completed after	113     iterations
BIT SIZE[15]   TEST[23]: Pre-Image Completed after	16515   iterations and collisions completed after	120     iterations
BIT SIZE[15]   TEST[24]: Pre-Image Completed after	20977   iterations and collisions completed after	129     iterations
BIT SIZE[15]   TEST[25]: Pre-Image Completed after	5680    iterations and collisions completed after	18      iterations
BIT SIZE[15]   TEST[26]: Pre-Image Completed after	10338   iterations and collisions completed after	168     iterations
BIT SIZE[15]   TEST[27]: Pre-Image Completed after	80757   iterations and collisions completed after	77      iterations
BIT SIZE[15]   TEST[28]: Pre-Image Completed after	13525   iterations and collisions completed after	205     iterations
BIT SIZE[15]   TEST[29]: Pre-Image Completed after	919     iterations and collisions completed after	176     iterations
BIT SIZE[15]   TEST[30]: Pre-Image Completed after	28311   iterations and collisions completed after	82      iterations
BIT SIZE[15]   TEST[31]: Pre-Image Completed after	4932    iterations and collisions completed after	167     iterations
BIT SIZE[15]   TEST[32]: Pre-Image Completed after	16724   iterations and collisions completed after	219     iterations
BIT SIZE[15]   TEST[33]: Pre-Image Completed after	26384   iterations and collisions completed after	308     iterations
BIT SIZE[15]   TEST[34]: Pre-Image Completed after	2092    iterations and collisions completed after	104     iterations
BIT SIZE[15]   TEST[35]: Pre-Image Completed after	3057    iterations and collisions completed after	207     iterations
BIT SIZE[15]   TEST[36]: Pre-Image Completed after	852     iterations and collisions completed after	144     iterations
BIT SIZE[15]   TEST[37]: Pre-Image Completed after	9875    iterations and collisions completed after	208     iterations
BIT SIZE[15]   TEST[38]: Pre-Image Completed after	18343   iterations and collisions completed after	39      iterations
BIT SIZE[15]   TEST[39]: Pre-Image Completed after	33557   iterations and collisions completed after	109     iterations
BIT SIZE[15]   TEST[40]: Pre-Image Completed after	37481   iterations and collisions completed after	91      iterations
BIT SIZE[15]   TEST[41]: Pre-Image Completed after	14421   iterations and collisions completed after	193     iterations
BIT SIZE[15]   TEST[42]: Pre-Image Completed after	39363   iterations and collisions completed after	192     iterations
BIT SIZE[15]   TEST[43]: Pre-Image Completed after	11505   iterations and collisions completed after	172     iterations
BIT SIZE[15]   TEST[44]: Pre-Image Completed after	13329   iterations and collisions completed after	29      iterations
BIT SIZE[15]   TEST[45]: Pre-Image Completed after	20372   iterations and collisions completed after	81      iterations
BIT SIZE[15]   TEST[46]: Pre-Image Completed after	3213    iterations and collisions completed after	206     iterations
BIT SIZE[15]   TEST[47]: Pre-Image Completed after	14127   iterations and collisions completed after	97      iterations
BIT SIZE[15]   TEST[48]: Pre-Image Completed after	627     iterations and collisions completed after	285     iterations
BIT SIZE[15]   TEST[49]: Pre-Image Completed after	6783    iterations and collisions completed after	130     iterations
BIT SIZE[16]   TEST[0]:  Pre-Image Completed after	43328   iterations and collisions completed after	150     iterations
BIT SIZE[16]   TEST[1]:  Pre-Image Completed after	8135    iterations and collisions completed after	340     iterations
BIT SIZE[16]   TEST[2]:  Pre-Image Completed after	11926   iterations and collisions completed after	254     iterations
BIT SIZE[16]   TEST[3]:  Pre-Image Completed after	21671   iterations and collisions completed after	178     iterations
BIT SIZE[16]   TEST[4]:  Pre-Image Completed after	20241   iterations and collisions completed after	125     iterations
BIT SIZE[16]   TEST[5]:  Pre-Image Completed after	601370  iterations and collisions completed after	375     iterations
BIT SIZE[16]   TEST[6]:  Pre-Image Completed after	9130    iterations and collisions completed after	141     iterations
BIT SIZE[16]   TEST[7]:  Pre-Image Completed after	7424    iterations and collisions completed after	149     iterations
BIT SIZE[16]   TEST[8]:  Pre-Image Completed after	3788    iterations and collisions completed after	241     iterations
BIT SIZE[16]   TEST[9]:  Pre-Image Completed after	118105  iterations and collisions completed after	278     iterations
BIT SIZE[16]   TEST[10]: Pre-Image Completed after	1948    iterations and collisions completed after	199     iterations
BIT SIZE[16]   TEST[11]: Pre-Image Completed after	9260    iterations and collisions completed after	60      iterations
BIT SIZE[16]   TEST[12]: Pre-Image Completed after	11252   iterations and collisions completed after	78      iterations
BIT SIZE[16]   TEST[13]: Pre-Image Completed after	9274    iterations and collisions completed after	163     iterations
BIT SIZE[16]   TEST[14]: Pre-Image Completed after	1315    iterations and collisions completed after	180     iterations
BIT SIZE[16]   TEST[15]: Pre-Image Completed after	9583    iterations and collisions completed after	101     iterations
BIT SIZE[16]   TEST[16]: Pre-Image Completed after	991     iterations and collisions completed after	94      iterations
BIT SIZE[16]   TEST[17]: Pre-Image Completed after	12320   iterations and collisions completed after	169     iterations
BIT SIZE[16]   TEST[18]: Pre-Image Completed after	44301   iterations and collisions completed after	116     iterations
BIT SIZE[16]   TEST[19]: Pre-Image Completed after	1152    iterations and collisions completed after	168     iterations
BIT SIZE[16]   TEST[20]: Pre-Image Completed after	75064   iterations and collisions completed after	45      iterations
BIT SIZE[16]   TEST[21]: Pre-Image Completed after	12823   iterations and collisions completed after	358     iterations
BIT SIZE[16]   TEST[22]: Pre-Image Completed after	28214   iterations and collisions completed after	53      iterations
BIT SIZE[16]   TEST[23]: Pre-Image Completed after	50053   iterations and collisions completed after	121     iterations
BIT SIZE[16]   TEST[24]: Pre-Image Completed after	71504   iterations and collisions completed after	173     iterations
BIT SIZE[16]   TEST[25]: Pre-Image Completed after	21743   iterations and collisions completed after	77      iterations
BIT SIZE[16]   TEST[26]: Pre-Image Completed after	36455   iterations and collisions completed after	180     iterations
BIT SIZE[16]   TEST[27]: Pre-Image Completed after	87589   iterations and collisions completed after	121     iterations
BIT SIZE[16]   TEST[28]: Pre-Image Completed after	1828    iterations and collisions completed after	71      iterations
BIT SIZE[16]   TEST[29]: Pre-Image Completed after	15140   iterations and collisions completed after	248     iterations
BIT SIZE[16]   TEST[30]: Pre-Image Completed after	24203   iterations and collisions completed after	303     iterations
BIT SIZE[16]   TEST[31]: Pre-Image Completed after	116178  iterations and collisions completed after	322     iterations
BIT SIZE[16]   TEST[32]: Pre-Image Completed after	1116    iterations and collisions completed after	237     iterations
BIT SIZE[16]   TEST[33]: Pre-Image Completed after	25690   iterations and collisions completed after	185     iterations
BIT SIZE[16]   TEST[34]: Pre-Image Completed after	6321    iterations and collisions completed after	155     iterations
BIT SIZE[16]   TEST[35]: Pre-Image Completed after	17662   iterations and collisions completed after	206     iterations
BIT SIZE[16]   TEST[36]: Pre-Image Completed after	11511   iterations and collisions completed after	122     iterations
BIT SIZE[16]   TEST[37]: Pre-Image Completed after	29015   iterations and collisions completed after	230     iterations
BIT SIZE[16]   TEST[38]: Pre-Image Completed after	94830   iterations and collisions completed after	258     iterations
BIT SIZE[16]   TEST[39]: Pre-Image Completed after	28271   iterations and collisions completed after	71      iterations
BIT SIZE[16]   TEST[40]: Pre-Image Completed after	9902    iterations and collisions completed after	174     iterations
BIT SIZE[16]   TEST[41]: Pre-Image Completed after	45191   iterations and collisions completed after	46      iterations
BIT SIZE[16]   TEST[42]: Pre-Image Completed after	4378    iterations and collisions completed after	170     iterations
BIT SIZE[16]   TEST[43]: Pre-Image Completed after	61920   iterations and collisions completed after	49      iterations
BIT SIZE[16]   TEST[44]: Pre-Image Completed after	73415   iterations and collisions completed after	124     iterations
BIT SIZE[16]   TEST[45]: Pre-Image Completed after	83484   iterations and collisions completed after	132     iterations
BIT SIZE[16]   TEST[46]: Pre-Image Completed after	15494   iterations and collisions completed after	256     iterations
BIT SIZE[16]   TEST[47]: Pre-Image Completed after	26351   iterations and collisions completed after	270     iterations
BIT SIZE[16]   TEST[48]: Pre-Image Completed after	1771    iterations and collisions completed after	268     iterations
BIT SIZE[16]   TEST[49]: Pre-Image Completed after	40908   iterations and collisions completed after	99      iterations
BIT SIZE[17]   TEST[0]:  Pre-Image Completed after	40210   iterations and collisions completed after	392     iterations
BIT SIZE[17]   TEST[1]:  Pre-Image Completed after	123339  iterations and collisions completed after	414     iterations
BIT SIZE[17]   TEST[2]:  Pre-Image Completed after	65281   iterations and collisions completed after	24      iterations
BIT SIZE[17]   TEST[3]:  Pre-Image Completed after	24664   iterations and collisions completed after	149     iterations
BIT SIZE[17]   TEST[4]:  Pre-Image Completed after	20968   iterations and collisions completed after	352     iterations
BIT SIZE[17]   TEST[5]:  Pre-Image Completed after	37555   iterations and collisions completed after	175     iterations
BIT SIZE[17]   TEST[6]:  Pre-Image Completed after	17668   iterations and collisions completed after	362     iterations
BIT SIZE[17]   TEST[7]:  Pre-Image Completed after	48450   iterations and collisions completed after	619     iterations
BIT SIZE[17]   TEST[8]:  Pre-Image Completed after	62336   iterations and collisions completed after	67      iterations
BIT SIZE[17]   TEST[9]:  Pre-Image Completed after	4305    iterations and collisions completed after	182     iterations
BIT SIZE[17]   TEST[10]: Pre-Image Completed after	18657   iterations and collisions completed after	394     iterations
BIT SIZE[17]   TEST[11]: Pre-Image Completed after	59582   iterations and collisions completed after	597     iterations
BIT SIZE[17]   TEST[12]: Pre-Image Completed after	59389   iterations and collisions completed after	255     iterations
BIT SIZE[17]   TEST[13]: Pre-Image Completed after	31589   iterations and collisions completed after	276     iterations
BIT SIZE[17]   TEST[14]: Pre-Image Completed after	39627   iterations and collisions completed after	265     iterations
BIT SIZE[17]   TEST[15]: Pre-Image Completed after	2593    iterations and collisions completed after	147     iterations
BIT SIZE[17]   TEST[16]: Pre-Image Completed after	15966   iterations and collisions completed after	273     iterations
BIT SIZE[17]   TEST[17]: Pre-Image Completed after	28968   iterations and collisions completed after	411     iterations
BIT SIZE[17]   TEST[18]: Pre-Image Completed after	50458   iterations and collisions completed after	246     iterations
BIT SIZE[17]   TEST[19]: Pre-Image Completed after	3655    iterations and collisions completed after	373     iterations
BIT SIZE[17]   TEST[20]: Pre-Image Completed after	52533   iterations and collisions completed after	84      iterations
BIT SIZE[17]   TEST[21]: Pre-Image Completed after	5121    iterations and collisions completed after	237     iterations
BIT SIZE[17]   TEST[22]: Pre-Image Completed after	106832  iterations and collisions completed after	352     iterations
BIT SIZE[17]   TEST[23]: Pre-Image Completed after	401419  iterations and collisions completed after	99      iterations
BIT SIZE[17]   TEST[24]: Pre-Image Completed after	33293   iterations and collisions completed after	172     iterations
BIT SIZE[17]   TEST[25]: Pre-Image Completed after	94475   iterations and collisions completed after	513     iterations
BIT SIZE[17]   TEST[26]: Pre-Image Completed after	16439   iterations and collisions completed after	51      iterations
BIT SIZE[17]   TEST[27]: Pre-Image Completed after	13494   iterations and collisions completed after	299     iterations
BIT SIZE[17]   TEST[28]: Pre-Image Completed after	34290   iterations and collisions completed after	640     iterations
BIT SIZE[17]   TEST[29]: Pre-Image Completed after	74353   iterations and collisions completed after	306     iterations
BIT SIZE[17]   TEST[30]: Pre-Image Completed after	6884    iterations and collisions completed after	279     iterations
BIT SIZE[17]   TEST[31]: Pre-Image Completed after	3140    iterations and collisions completed after	152     iterations
BIT SIZE[17]   TEST[32]: Pre-Image Completed after	21952   iterations and collisions completed after	222     iterations
BIT SIZE[17]   TEST[33]: Pre-Image Completed after	1704    iterations and collisions completed after	415     iterations
BIT SIZE[17]   TEST[34]: Pre-Image Completed after	8729    iterations and collisions completed after	253     iterations
BIT SIZE[17]   TEST[35]: Pre-Image Completed after	39556   iterations and collisions completed after	494     iterations
BIT SIZE[17]   TEST[36]: Pre-Image Completed after	41104   iterations and collisions completed after	306     iterations
BIT SIZE[17]   TEST[37]: Pre-Image Completed after	27158   iterations and collisions completed after	219     iterations
BIT SIZE[17]   TEST[38]: Pre-Image Completed after	40614   iterations and collisions completed after	403     iterations
BIT SIZE[17]   TEST[39]: Pre-Image Completed after	2682    iterations and collisions completed after	256     iterations
BIT SIZE[17]   TEST[40]: Pre-Image Completed after	5266    iterations and collisions completed after	166     iterations
BIT SIZE[17]   TEST[41]: Pre-Image Completed after	12696   iterations and collisions completed after	246     iterations
BIT SIZE[17]   TEST[42]: Pre-Image Completed after	27611   iterations and collisions completed after	109     iterations
BIT SIZE[17]   TEST[43]: Pre-Image Completed after	72569   iterations and collisions completed after	146     iterations
BIT SIZE[17]   TEST[44]: Pre-Image Completed after	227497  iterations and collisions completed after	192     iterations
BIT SIZE[17]   TEST[45]: Pre-Image Completed after	125639  iterations and collisions completed after	167     iterations
BIT SIZE[17]   TEST[46]: Pre-Image Completed after	77557   iterations and collisions completed after	433     iterations
BIT SIZE[17]   TEST[47]: Pre-Image Completed after	15260   iterations and collisions completed after	321     iterations
BIT SIZE[17]   TEST[48]: Pre-Image Completed after	7746    iterations and collisions completed after	141     iterations
BIT SIZE[17]   TEST[49]: Pre-Image Completed after	23808   iterations and collisions completed after	264     iterations
BIT SIZE[18]   TEST[0]:  Pre-Image Completed after	33722   iterations and collisions completed after	439     iterations
BIT SIZE[18]   TEST[1]:  Pre-Image Completed after	308552  iterations and collisions completed after	413     iterations
BIT SIZE[18]   TEST[2]:  Pre-Image Completed after	422661  iterations and collisions completed after	229     iterations
BIT SIZE[18]   TEST[3]:  Pre-Image Completed after	13640   iterations and collisions completed after	286     iterations
BIT SIZE[18]   TEST[4]:  Pre-Image Completed after	188872  iterations and collisions completed after	261     iterations
BIT SIZE[18]   TEST[5]:  Pre-Image Completed after	24022   iterations and collisions completed after	160     iterations
BIT SIZE[18]   TEST[6]:  Pre-Image Completed after	198640  iterations and collisions completed after	251     iterations
BIT SIZE[18]   TEST[7]:  Pre-Image Completed after	2827    iterations and collisions completed after	378     iterations
BIT SIZE[18]   TEST[8]:  Pre-Image Completed after	86109   iterations and collisions completed after	287     iterations
BIT SIZE[18]   TEST[9]:  Pre-Image Completed after	170499  iterations and collisions completed after	278     iterations
BIT SIZE[18]   TEST[10]: Pre-Image Completed after	44419   iterations and collisions completed after	407     iterations
BIT SIZE[18]   TEST[11]: Pre-Image Completed after	59396   iterations and collisions completed after	513     iterations
BIT SIZE[18]   TEST[12]: Pre-Image Completed after	48840   iterations and collisions completed after	512     iterations
BIT SIZE[18]   TEST[13]: Pre-Image Completed after	5589    iterations and collisions completed after	269     iterations
BIT SIZE[18]   TEST[14]: Pre-Image Completed after	165919  iterations and collisions completed after	226     iterations
BIT SIZE[18]   TEST[15]: Pre-Image Completed after	18396   iterations and collisions completed after	76      iterations
BIT SIZE[18]   TEST[16]: Pre-Image Completed after	223615  iterations and collisions completed after	85      iterations
BIT SIZE[18]   TEST[17]: Pre-Image Completed after	29669   iterations and collisions completed after	553     iterations
BIT SIZE[18]   TEST[18]: Pre-Image Completed after	49651   iterations and collisions completed after	209     iterations
BIT SIZE[18]   TEST[19]: Pre-Image Completed after	30063   iterations and collisions completed after	482     iterations
BIT SIZE[18]   TEST[20]: Pre-Image Completed after	123050  iterations and collisions completed after	446     iterations
BIT SIZE[18]   TEST[21]: Pre-Image Completed after	166245  iterations and collisions completed after	427     iterations
BIT SIZE[18]   TEST[22]: Pre-Image Completed after	8488    iterations and collisions completed after	510     iterations
BIT SIZE[18]   TEST[23]: Pre-Image Completed after	1531806 iterations and collisions completed after	500     iterations
BIT SIZE[18]   TEST[24]: Pre-Image Completed after	190457  iterations and collisions completed after	541     iterations
BIT SIZE[18]   TEST[25]: Pre-Image Completed after	47340   iterations and collisions completed after	256     iterations
BIT SIZE[18]   TEST[26]: Pre-Image Completed after	35186   iterations and collisions completed after	206     iterations
BIT SIZE[18]   TEST[27]: Pre-Image Completed after	71879   iterations and collisions completed after	247     iterations
BIT SIZE[18]   TEST[28]: Pre-Image Completed after	160646  iterations and collisions completed after	344     iterations
BIT SIZE[18]   TEST[29]: Pre-Image Completed after	688008  iterations and collisions completed after	223     iterations
BIT SIZE[18]   TEST[30]: Pre-Image Completed after	22375   iterations and collisions completed after	193     iterations
BIT SIZE[18]   TEST[31]: Pre-Image Completed after	67850   iterations and collisions completed after	263     iterations
BIT SIZE[18]   TEST[32]: Pre-Image Completed after	378426  iterations and collisions completed after	351     iterations
BIT SIZE[18]   TEST[33]: Pre-Image Completed after	176838  iterations and collisions completed after	184     iterations
BIT SIZE[18]   TEST[34]: Pre-Image Completed after	5806    iterations and collisions completed after	337     iterations
BIT SIZE[18]   TEST[35]: Pre-Image Completed after	4517    iterations and collisions completed after	368     iterations
BIT SIZE[18]   TEST[36]: Pre-Image Completed after	62145   iterations and collisions completed after	239     iterations
BIT SIZE[18]   TEST[37]: Pre-Image Completed after	22012   iterations and collisions completed after	333     iterations
BIT SIZE[18]   TEST[38]: Pre-Image Completed after	222800  iterations and collisions completed after	175     iterations
BIT SIZE[18]   TEST[39]: Pre-Image Completed after	20785   iterations and collisions completed after	358     iterations
BIT SIZE[18]   TEST[40]: Pre-Image Completed after	29284   iterations and collisions completed after	530     iterations
BIT SIZE[18]   TEST[41]: Pre-Image Completed after	81163   iterations and collisions completed after	54      iterations
BIT SIZE[18]   TEST[42]: Pre-Image Completed after	234467  iterations and collisions completed after	368     iterations
BIT SIZE[18]   TEST[43]: Pre-Image Completed after	5199    iterations and collisions completed after	52      iterations
BIT SIZE[18]   TEST[44]: Pre-Image Completed after	42209   iterations and collisions completed after	134     iterations
BIT SIZE[18]   TEST[45]: Pre-Image Completed after	119554  iterations and collisions completed after	269     iterations
BIT SIZE[18]   TEST[46]: Pre-Image Completed after	82667   iterations and collisions completed after	289     iterations
BIT SIZE[18]   TEST[47]: Pre-Image Completed after	67287   iterations and collisions completed after	298     iterations
BIT SIZE[18]   TEST[48]: Pre-Image Completed after	23886   iterations and collisions completed after	92      iterations
BIT SIZE[18]   TEST[49]: Pre-Image Completed after	20272   iterations and collisions completed after	387     iterations
BIT SIZE[19]   TEST[0]:  Pre-Image Completed after	422764  iterations and collisions completed after	790     iterations
BIT SIZE[19]   TEST[1]:  Pre-Image Completed after	42371   iterations and collisions completed after	930     iterations
BIT SIZE[19]   TEST[2]:  Pre-Image Completed after	903831  iterations and collisions completed after	644     iterations
BIT SIZE[19]   TEST[3]:  Pre-Image Completed after	178775  iterations and collisions completed after	415     iterations
BIT SIZE[19]   TEST[4]:  Pre-Image Completed after	38587   iterations and collisions completed after	458     iterations
BIT SIZE[19]   TEST[5]:  Pre-Image Completed after	14554   iterations and collisions completed after	716     iterations
BIT SIZE[19]   TEST[6]:  Pre-Image Completed after	2722    iterations and collisions completed after	469     iterations
BIT SIZE[19]   TEST[7]:  Pre-Image Completed after	9794    iterations and collisions completed after	337     iterations
BIT SIZE[19]   TEST[8]:  Pre-Image Completed after	229000  iterations and collisions completed after	590     iterations
BIT SIZE[19]   TEST[9]:  Pre-Image Completed after	49938   iterations and collisions completed after	203     iterations
BIT SIZE[19]   TEST[10]: Pre-Image Completed after	313111  iterations and collisions completed after	190     iterations
BIT SIZE[19]   TEST[11]: Pre-Image Completed after	355655  iterations and collisions completed after	500     iterations
BIT SIZE[19]   TEST[12]: Pre-Image Completed after	547706  iterations and collisions completed after	432     iterations
BIT SIZE[19]   TEST[13]: Pre-Image Completed after	118253  iterations and collisions completed after	366     iterations
BIT SIZE[19]   TEST[14]: Pre-Image Completed after	555454  iterations and collisions completed after	245     iterations
BIT SIZE[19]   TEST[15]: Pre-Image Completed after	39592   iterations and collisions completed after	819     iterations
BIT SIZE[19]   TEST[16]: Pre-Image Completed after	70361   iterations and collisions completed after	661     iterations
BIT SIZE[19]   TEST[17]: Pre-Image Completed after	103544  iterations and collisions completed after	236     iterations
BIT SIZE[19]   TEST[18]: Pre-Image Completed after	446460  iterations and collisions completed after	504     iterations
BIT SIZE[19]   TEST[19]: Pre-Image Completed after	474928  iterations and collisions completed after	434     iterations
BIT SIZE[19]   TEST[20]: Pre-Image Completed after	262809  iterations and collisions completed after	563     iterations
BIT SIZE[19]   TEST[21]: Pre-Image Completed after	44693   iterations and collisions completed after	779     iterations
BIT SIZE[19]   TEST[22]: Pre-Image Completed after	225229  iterations and collisions completed after	472     iterations
BIT SIZE[19]   TEST[23]: Pre-Image Completed after	103804  iterations and collisions completed after	1336    iterations
BIT SIZE[19]   TEST[24]: Pre-Image Completed after	654018  iterations and collisions completed after	393     iterations
BIT SIZE[19]   TEST[25]: Pre-Image Completed after	143680  iterations and collisions completed after	402     iterations
BIT SIZE[19]   TEST[26]: Pre-Image Completed after	117698  iterations and collisions completed after	206     iterations
BIT SIZE[19]   TEST[27]: Pre-Image Completed after	258566  iterations and collisions completed after	51      iterations
BIT SIZE[19]   TEST[28]: Pre-Image Completed after	52460   iterations and collisions completed after	578     iterations
BIT SIZE[19]   TEST[29]: Pre-Image Completed after	107641  iterations and collisions completed after	287     iterations
BIT SIZE[19]   TEST[30]: Pre-Image Completed after	108509  iterations and collisions completed after	556     iterations
BIT SIZE[19]   TEST[31]: Pre-Image Completed after	4693    iterations and collisions completed after	671     iterations
BIT SIZE[19]   TEST[32]: Pre-Image Completed after	313816  iterations and collisions completed after	536     iterations
BIT SIZE[19]   TEST[33]: Pre-Image Completed after	116086  iterations and collisions completed after	663     iterations
BIT SIZE[19]   TEST[34]: Pre-Image Completed after	128054  iterations and collisions completed after	325     iterations
BIT SIZE[19]   TEST[35]: Pre-Image Completed after	186735  iterations and collisions completed after	596     iterations
BIT SIZE[19]   TEST[36]: Pre-Image Completed after	1074    iterations and collisions completed after	526     iterations
BIT SIZE[19]   TEST[37]: Pre-Image Completed after	4361    iterations and collisions completed after	530     iterations
BIT SIZE[19]   TEST[38]: Pre-Image Completed after	157440  iterations and collisions completed after	287     iterations
BIT SIZE[19]   TEST[39]: Pre-Image Completed after	68064   iterations and collisions completed after	347     iterations
BIT SIZE[19]   TEST[40]: Pre-Image Completed after	67960   iterations and collisions completed after	634     iterations
BIT SIZE[19]   TEST[41]: Pre-Image Completed after	663024  iterations and collisions completed after	871     iterations
BIT SIZE[19]   TEST[42]: Pre-Image Completed after	209783  iterations and collisions completed after	781     iterations
BIT SIZE[19]   TEST[43]: Pre-Image Completed after	121969  iterations and collisions completed after	355     iterations
BIT SIZE[19]   TEST[44]: Pre-Image Completed after	77589   iterations and collisions completed after	642     iterations
BIT SIZE[19]   TEST[45]: Pre-Image Completed after	45947   iterations and collisions completed after	714     iterations
BIT SIZE[19]   TEST[46]: Pre-Image Completed after	62759   iterations and collisions completed after	617     iterations
BIT SIZE[19]   TEST[47]: Pre-Image Completed after	427734  iterations and collisions completed after	242     iterations
BIT SIZE[19]   TEST[48]: Pre-Image Completed after	53378   iterations and collisions completed after	768     iterations
BIT SIZE[19]   TEST[49]: Pre-Image Completed after	736337  iterations and collisions completed after	245     iterations
BIT SIZE[20]   TEST[0]:  Pre-Image Completed after	264351  iterations and collisions completed after	692     iterations
BIT SIZE[20]   TEST[1]:  Pre-Image Completed after	195168  iterations and collisions completed after	669     iterations
BIT SIZE[20]   TEST[2]:  Pre-Image Completed after	3158    iterations and collisions completed after	1079    iterations
BIT SIZE[20]   TEST[3]:  Pre-Image Completed after	293300  iterations and collisions completed after	898     iterations
BIT SIZE[20]   TEST[4]:  Pre-Image Completed after	500294  iterations and collisions completed after	720     iterations
BIT SIZE[20]   TEST[5]:  Pre-Image Completed after	528374  iterations and collisions completed after	1063    iterations
BIT SIZE[20]   TEST[6]:  Pre-Image Completed after	114717  iterations and collisions completed after	661     iterations
BIT SIZE[20]   TEST[7]:  Pre-Image Completed after	479636  iterations and collisions completed after	194     iterations
BIT SIZE[20]   TEST[8]:  Pre-Image Completed after	2328650 iterations and collisions completed after	742     iterations
BIT SIZE[20]   TEST[9]:  Pre-Image Completed after	516207  iterations and collisions completed after	631     iterations
BIT SIZE[20]   TEST[10]: Pre-Image Completed after	981543  iterations and collisions completed after	424     iterations
BIT SIZE[20]   TEST[11]: Pre-Image Completed after	267348  iterations and collisions completed after	543     iterations
BIT SIZE[20]   TEST[12]: Pre-Image Completed after	413382  iterations and collisions completed after	601     iterations
BIT SIZE[20]   TEST[13]: Pre-Image Completed after	191344  iterations and collisions completed after	665     iterations
BIT SIZE[20]   TEST[14]: Pre-Image Completed after	897579  iterations and collisions completed after	471     iterations
BIT SIZE[20]   TEST[15]: Pre-Image Completed after	26552   iterations and collisions completed after	243     iterations
BIT SIZE[20]   TEST[16]: Pre-Image Completed after	206530  iterations and collisions completed after	340     iterations
BIT SIZE[20]   TEST[17]: Pre-Image Completed after	80652   iterations and collisions completed after	295     iterations
BIT SIZE[20]   TEST[18]: Pre-Image Completed after	150739  iterations and collisions completed after	1045    iterations
BIT SIZE[20]   TEST[19]: Pre-Image Completed after	96053   iterations and collisions completed after	986     iterations
BIT SIZE[20]   TEST[20]: Pre-Image Completed after	20558   iterations and collisions completed after	158     iterations
BIT SIZE[20]   TEST[21]: Pre-Image Completed after	111456  iterations and collisions completed after	412     iterations
BIT SIZE[20]   TEST[22]: Pre-Image Completed after	349333  iterations and collisions completed after	1104    iterations
BIT SIZE[20]   TEST[23]: Pre-Image Completed after	10998   iterations and collisions completed after	271     iterations
BIT SIZE[20]   TEST[24]: Pre-Image Completed after	449899  iterations and collisions completed after	1008    iterations
BIT SIZE[20]   TEST[25]: Pre-Image Completed after	694261  iterations and collisions completed after	672     iterations
BIT SIZE[20]   TEST[26]: Pre-Image Completed after	749266  iterations and collisions completed after	422     iterations
BIT SIZE[20]   TEST[27]: Pre-Image Completed after	1143276 iterations and collisions completed after	1079    iterations
BIT SIZE[20]   TEST[28]: Pre-Image Completed after	371722  iterations and collisions completed after	1569    iterations
BIT SIZE[20]   TEST[29]: Pre-Image Completed after	6027    iterations and collisions completed after	275     iterations
BIT SIZE[20]   TEST[30]: Pre-Image Completed after	2311725 iterations and collisions completed after	906     iterations
BIT SIZE[20]   TEST[31]: Pre-Image Completed after	1680187 iterations and collisions completed after	1522    iterations
BIT SIZE[20]   TEST[32]: Pre-Image Completed after	81487   iterations and collisions completed after	841     iterations
BIT SIZE[20]   TEST[33]: Pre-Image Completed after	586347  iterations and collisions completed after	757     iterations
BIT SIZE[20]   TEST[34]: Pre-Image Completed after	67892   iterations and collisions completed after	712     iterations
BIT SIZE[20]   TEST[35]: Pre-Image Completed after	33947   iterations and collisions completed after	904     iterations
BIT SIZE[20]   TEST[36]: Pre-Image Completed after	254576  iterations and collisions completed after	441     iterations
BIT SIZE[20]   TEST[37]: Pre-Image Completed after	642197  iterations and collisions completed after	1017    iterations
BIT SIZE[20]   TEST[38]: Pre-Image Completed after	4516481 iterations and collisions completed after	388     iterations
BIT SIZE[20]   TEST[39]: Pre-Image Completed after	181025  iterations and collisions completed after	660     iterations
BIT SIZE[20]   TEST[40]: Pre-Image Completed after	275916  iterations and collisions completed after	850     iterations
BIT SIZE[20]   TEST[41]: Pre-Image Completed after	659742  iterations and collisions completed after	1032    iterations
BIT SIZE[20]   TEST[42]: Pre-Image Completed after	126337  iterations and collisions completed after	944     iterations
BIT SIZE[20]   TEST[43]: Pre-Image Completed after	1220485 iterations and collisions completed after	348     iterations
BIT SIZE[20]   TEST[44]: Pre-Image Completed after	194771  iterations and collisions completed after	1219    iterations
BIT SIZE[20]   TEST[45]: Pre-Image Completed after	75087   iterations and collisions completed after	1484    iterations
BIT SIZE[20]   TEST[46]: Pre-Image Completed after	27546   iterations and collisions completed after	390     iterations
BIT SIZE[20]   TEST[47]: Pre-Image Completed after	240973  iterations and collisions completed after	1138    iterations
BIT SIZE[20]   TEST[48]: Pre-Image Completed after	168866  iterations and collisions completed after	1146    iterations
BIT SIZE[20]   TEST[49]: Pre-Image Completed after	78259   iterations and collisions completed after	581     iterations
BIT SIZE[21]   TEST[0]:  Pre-Image Completed after	4802081 iterations and collisions completed after	1787    iterations
BIT SIZE[21]   TEST[1]:  Pre-Image Completed after	894920  iterations and collisions completed after	297     iterations
BIT SIZE[21]   TEST[2]:  Pre-Image Completed after	2793156 iterations and collisions completed after	308     iterations
BIT SIZE[21]   TEST[3]:  Pre-Image Completed after	213811  iterations and collisions completed after	256     iterations
BIT SIZE[21]   TEST[4]:  Pre-Image Completed after	506199  iterations and collisions completed after	737     iterations
BIT SIZE[21]   TEST[5]:  Pre-Image Completed after	2289760 iterations and collisions completed after	740     iterations
BIT SIZE[21]   TEST[6]:  Pre-Image Completed after	13181   iterations and collisions completed after	779     iterations
BIT SIZE[21]   TEST[7]:  Pre-Image Completed after	200087  iterations and collisions completed after	1936    iterations
BIT SIZE[21]   TEST[8]:  Pre-Image Completed after	1531998 iterations and collisions completed after	676     iterations
BIT SIZE[21]   TEST[9]:  Pre-Image Completed after	600922  iterations and collisions completed after	1184    iterations
BIT SIZE[21]   TEST[10]: Pre-Image Completed after	160748  iterations and collisions completed after	695     iterations
BIT SIZE[21]   TEST[11]: Pre-Image Completed after	1426837 iterations and collisions completed after	1150    iterations
BIT SIZE[21]   TEST[12]: Pre-Image Completed after	296589  iterations and collisions completed after	2073    iterations
BIT SIZE[21]   TEST[13]: Pre-Image Completed after	27866   iterations and collisions completed after	1244    iterations
BIT SIZE[21]   TEST[14]: Pre-Image Completed after	952254  iterations and collisions completed after	1266    iterations
BIT SIZE[21]   TEST[15]: Pre-Image Completed after	133169  iterations and collisions completed after	1033    iterations
BIT SIZE[21]   TEST[16]: Pre-Image Completed after	349778  iterations and collisions completed after	531     iterations
BIT SIZE[21]   TEST[17]: Pre-Image Completed after	174502  iterations and collisions completed after	601     iterations
BIT SIZE[21]   TEST[18]: Pre-Image Completed after	1511359 iterations and collisions completed after	1135    iterations
BIT SIZE[21]   TEST[19]: Pre-Image Completed after	865916  iterations and collisions completed after	955     iterations
BIT SIZE[21]   TEST[20]: Pre-Image Completed after	406094  iterations and collisions completed after	1563    iterations
BIT SIZE[21]   TEST[21]: Pre-Image Completed after	917697  iterations and collisions completed after	877     iterations
BIT SIZE[21]   TEST[22]: Pre-Image Completed after	343571  iterations and collisions completed after	777     iterations
BIT SIZE[21]   TEST[23]: Pre-Image Completed after	397314  iterations and collisions completed after	1035    iterations
BIT SIZE[21]   TEST[24]: Pre-Image Completed after	262677  iterations and collisions completed after	1410    iterations
BIT SIZE[21]   TEST[25]: Pre-Image Completed after	1273219 iterations and collisions completed after	563     iterations
BIT SIZE[21]   TEST[26]: Pre-Image Completed after	216897  iterations and collisions completed after	647     iterations
BIT SIZE[21]   TEST[27]: Pre-Image Completed after	81788   iterations and collisions completed after	1756    iterations
BIT SIZE[21]   TEST[28]: Pre-Image Completed after	1432060 iterations and collisions completed after	431     iterations
BIT SIZE[21]   TEST[29]: Pre-Image Completed after	323053  iterations and collisions completed after	360     iterations
BIT SIZE[21]   TEST[30]: Pre-Image Completed after	151221  iterations and collisions completed after	524     iterations
BIT SIZE[21]   TEST[31]: Pre-Image Completed after	1268978 iterations and collisions completed after	1021    iterations
BIT SIZE[21]   TEST[32]: Pre-Image Completed after	1413618 iterations and collisions completed after	483     iterations
BIT SIZE[21]   TEST[33]: Pre-Image Completed after	22622   iterations and collisions completed after	276     iterations
BIT SIZE[21]   TEST[34]: Pre-Image Completed after	226517  iterations and collisions completed after	768     iterations
BIT SIZE[21]   TEST[35]: Pre-Image Completed after	1047    iterations and collisions completed after	543     iterations
BIT SIZE[21]   TEST[36]: Pre-Image Completed after	4912256 iterations and collisions completed after	855     iterations
BIT SIZE[21]   TEST[37]: Pre-Image Completed after	748796  iterations and collisions completed after	838     iterations
BIT SIZE[21]   TEST[38]: Pre-Image Completed after	782609  iterations and collisions completed after	424     iterations
BIT SIZE[21]   TEST[39]: Pre-Image Completed after	772652  iterations and collisions completed after	1235    iterations
BIT SIZE[21]   TEST[40]: Pre-Image Completed after	1699687 iterations and collisions completed after	551     iterations
BIT SIZE[21]   TEST[41]: Pre-Image Completed after	2035832 iterations and collisions completed after	1976    iterations
BIT SIZE[21]   TEST[42]: Pre-Image Completed after	2816862 iterations and collisions completed after	1713    iterations
BIT SIZE[21]   TEST[43]: Pre-Image Completed after	357371  iterations and collisions completed after	1858    iterations
BIT SIZE[21]   TEST[44]: Pre-Image Completed after	46007   iterations and collisions completed after	548     iterations
BIT SIZE[21]   TEST[45]: Pre-Image Completed after	433199  iterations and collisions completed after	1540    iterations
BIT SIZE[21]   TEST[46]: Pre-Image Completed after	1851060 iterations and collisions completed after	1247    iterations
BIT SIZE[21]   TEST[47]: Pre-Image Completed after	800242  iterations and collisions completed after	668     iterations
BIT SIZE[21]   TEST[48]: Pre-Image Completed after	104761  iterations and collisions completed after	716     iterations
BIT SIZE[21]   TEST[49]: Pre-Image Completed after	1369009 iterations and collisions completed after	149     iterations
BIT SIZE[22]   TEST[0]:  Pre-Image Completed after	537176  iterations and collisions completed after	931     iterations
BIT SIZE[22]   TEST[1]:  Pre-Image Completed after	2654541 iterations and collisions completed after	1155    iterations
BIT SIZE[22]   TEST[2]:  Pre-Image Completed after	3998201 iterations and collisions completed after	926     iterations
BIT SIZE[22]   TEST[3]:  Pre-Image Completed after	1820048 iterations and collisions completed after	666     iterations
BIT SIZE[22]   TEST[4]:  Pre-Image Completed after	2316325 iterations and collisions completed after	2380    iterations
BIT SIZE[22]   TEST[5]:  Pre-Image Completed after	233374  iterations and collisions completed after	1738    iterations
BIT SIZE[22]   TEST[6]:  Pre-Image Completed after	4384112 iterations and collisions completed after	605     iterations
BIT SIZE[22]   TEST[7]:  Pre-Image Completed after	1691981 iterations and collisions completed after	752     iterations
BIT SIZE[22]   TEST[8]:  Pre-Image Completed after	307568  iterations and collisions completed after	924     iterations
BIT SIZE[22]   TEST[9]:  Pre-Image Completed after	58264   iterations and collisions completed after	1544    iterations
BIT SIZE[22]   TEST[10]: Pre-Image Completed after	2550891 iterations and collisions completed after	1253    iterations
BIT SIZE[22]   TEST[11]: Pre-Image Completed after	557096  iterations and collisions completed after	1874    iterations
BIT SIZE[22]   TEST[12]: Pre-Image Completed after	318908  iterations and collisions completed after	334     iterations
BIT SIZE[22]   TEST[13]: Pre-Image Completed after	23120   iterations and collisions completed after	1623    iterations
BIT SIZE[22]   TEST[14]: Pre-Image Completed after	169474  iterations and collisions completed after	804     iterations
BIT SIZE[22]   TEST[15]: Pre-Image Completed after	1266002 iterations and collisions completed after	664     iterations
BIT SIZE[22]   TEST[16]: Pre-Image Completed after	1010324 iterations and collisions completed after	599     iterations
BIT SIZE[22]   TEST[17]: Pre-Image Completed after	349302  iterations and collisions completed after	2616    iterations
BIT SIZE[22]   TEST[18]: Pre-Image Completed after	269261  iterations and collisions completed after	1485    iterations
BIT SIZE[22]   TEST[19]: Pre-Image Completed after	234612  iterations and collisions completed after	387     iterations
BIT SIZE[22]   TEST[20]: Pre-Image Completed after	56012   iterations and collisions completed after	845     iterations
BIT SIZE[22]   TEST[21]: Pre-Image Completed after	3675163 iterations and collisions completed after	2226    iterations
BIT SIZE[22]   TEST[22]: Pre-Image Completed after	1127653 iterations and collisions completed after	1363    iterations
BIT SIZE[22]   TEST[23]: Pre-Image Completed after	649909  iterations and collisions completed after	1545    iterations
BIT SIZE[22]   TEST[24]: Pre-Image Completed after	1223367 iterations and collisions completed after	3019    iterations
BIT SIZE[22]   TEST[25]: Pre-Image Completed after	1439406 iterations and collisions completed after	242     iterations
BIT SIZE[22]   TEST[26]: Pre-Image Completed after	2330855 iterations and collisions completed after	1491    iterations
BIT SIZE[22]   TEST[27]: Pre-Image Completed after	2831137 iterations and collisions completed after	2521    iterations
BIT SIZE[22]   TEST[28]: Pre-Image Completed after	288988  iterations and collisions completed after	163     iterations
BIT SIZE[22]   TEST[29]: Pre-Image Completed after	1158952 iterations and collisions completed after	943     iterations
BIT SIZE[22]   TEST[30]: Pre-Image Completed after	86930   iterations and collisions completed after	943     iterations
BIT SIZE[22]   TEST[31]: Pre-Image Completed after	186037  iterations and collisions completed after	740     iterations
BIT SIZE[22]   TEST[32]: Pre-Image Completed after	81826   iterations and collisions completed after	74      iterations
BIT SIZE[22]   TEST[33]: Pre-Image Completed after	2120495 iterations and collisions completed after	1139    iterations
BIT SIZE[22]   TEST[34]: Pre-Image Completed after	557292  iterations and collisions completed after	694     iterations
BIT SIZE[22]   TEST[35]: Pre-Image Completed after	2456186 iterations and collisions completed after	352     iterations
BIT SIZE[22]   TEST[36]: Pre-Image Completed after	4607786 iterations and collisions completed after	728     iterations
BIT SIZE[22]   TEST[37]: Pre-Image Completed after	444450  iterations and collisions completed after	1720    iterations
BIT SIZE[22]   TEST[38]: Pre-Image Completed after	4278107 iterations and collisions completed after	653     iterations
BIT SIZE[22]   TEST[39]: Pre-Image Completed after	881179  iterations and collisions completed after	555     iterations
BIT SIZE[22]   TEST[40]: Pre-Image Completed after	977650  iterations and collisions completed after	491     iterations
BIT SIZE[22]   TEST[41]: Pre-Image Completed after	378503  iterations and collisions completed after	2116    iterations
BIT SIZE[22]   TEST[42]: Pre-Image Completed after	6311339 iterations and collisions completed after	1277    iterations
BIT SIZE[22]   TEST[43]: Pre-Image Completed after	1566701 iterations and collisions completed after	1768    iterations
BIT SIZE[22]   TEST[44]: Pre-Image Completed after	1299018 iterations and collisions completed after	470     iterations
BIT SIZE[22]   TEST[45]: Pre-Image Completed after	5540123 iterations and collisions completed after	1297    iterations
BIT SIZE[22]   TEST[46]: Pre-Image Completed after	1194717 iterations and collisions completed after	1642    iterations
BIT SIZE[22]   TEST[47]: Pre-Image Completed after	943668  iterations and collisions completed after	946     iterations
BIT SIZE[22]   TEST[48]: Pre-Image Completed after	40678   iterations and collisions completed after	1749    iterations
BIT SIZE[22]   TEST[49]: Pre-Image Completed after	747297  iterations and collisions completed after	2098    iterations
